,Country/Territory,Region,C/T?,Edition,Status,PR Rating,CL Rating,Electoral Process,Pol Pluralism & Participation,Funding of Government,Add Q,PR,Freedom of Expression and Belief,Associational & Organization Rights,Rule of Law,Personal Autonomy and Ind. Rights,Civil Liberties,Total
0,Abkhazia,Eurasia,t,2021,PF,5,5,5,8,4,0,17,8,6,4,5,23,40
1,Afghanistan,Asia,c,2021,NF,5,6,3,7,3,0,13,6,4,2,2,14,27
2,Albania,Europe,c,2021,PF,3,3,8,12,7,0,27,13,8,9,9,39,66
3,Algeria,MENA,c,2021,NF,6,5,3,4,3,0,10,6,3,6,7,22,32
4,Andorra,Europe,c,2021,F,1,1,12,15,11,0,38,14,11,15,15,55,93
5,Angola,SSA,c,2021,NF,6,5,3,5,2,0,10,7,6,5,3,21,31
6,Antigua and Barbuda,Americas,c,2021,F,2,2,12,13,8,0,33,15,10,14,13,52,85
7,Argentina,Americas,c,2021,F,2,2,11,16,8,0,35,15,11,10,13,49,84
8,Armenia,Eurasia,c,2021,PF,4,4,6,10,6,0,22,9,8,6,10,33,55
9,Australia,Asia,c,2021,F,1,1,12,16,12,0,40,15,12,15,15,57,97
10,Austria,Europe,c,2021,F,1,1,12,15,10,0,37,14,12,15,15,56,93
11,Azerbaijan,Eurasia,c,2021,NF,7,6,0,2,0,0,2,2,1,0,5,8,10
12,Bahamas,Americas,c,2021,F,1,1,12,16,10,0,38,15,12,13,13,53,91
13,Bahrain,MENA,c,2021,NF,7,6,2,0,2,2,2,2,1,1,6,10,12
14,Bangladesh,Asia,c,2021,PF,5,5,4,7,4,0,15,6,5,4,9,24,39
15,Barbados,Americas,c,2021,F,1,1,12,16,10,0,38,16,12,14,15,57,95
16,Belarus,Eurasia,c,2021,NF,7,6,0,1,1,0,2,2,1,1,5,9,11
17,Belgium,Europe,c,2021,F,1,1,12,16,11,0,39,15,12,15,15,57,96
18,Belize,Americas,c,2021,F,2,1,12,14,8,0,34,16,11,13,13,53,87
19,Benin,SSA,c,2021,PF,4,2,5,9,7,0,21,14,9,11,10,44,65
20,Bhutan,Asia,c,2021,PF,2,4,10,12,9,1,30,9,5,8,9,31,61
21,Bolivia,Americas,c,2021,PF,3,3,10,10,7,0,27,14,9,6,10,39,66
22,Bosnia and Herzegovina,Europe,c,2021,PF,4,4,6,9,4,0,19,10,7,7,10,34,53
23,Botswana,SSA,c,2021,F,3,2,10,10,8,0,28,12,10,11,11,44,72
24,Brazil,Americas,c,2021,F,2,3,10,14,7,0,31,14,9,8,12,43,74
25,Brunei,Asia,c,2021,NF,6,5,0,3,4,0,7,6,3,5,7,21,28
26,Bulgaria,Europe,c,2021,F,2,2,11,14,8,0,33,13,11,10,11,45,78
27,Burkina Faso,SSA,c,2021,PF,4,4,7,10,6,0,23,11,8,5,7,31,54
28,Burundi,SSA,c,2021,NF,7,6,1,3,0,0,4,4,1,1,4,10,14
29,Cabo Verde,SSA,c,2021,F,1,1,12,16,10,0,38,16,11,14,13,54,92
30,Cambodia,Asia,c,2021,NF,7,5,1,2,2,0,5,7,3,3,6,19,24
31,Cameroon,SSA,c,2021,NF,6,6,1,3,3,0,7,4,2,0,3,9,16
32,Canada,Americas,c,2021,F,1,1,12,16,12,0,40,15,12,15,16,58,98
33,Central African Republic,SSA,c,2021,NF,7,7,2,2,0,1,3,4,1,1,0,6,9
34,Chad,SSA,c,2021,NF,7,6,1,1,1,0,3,6,4,1,3,14,17
35,Chile,Americas,c,2021,F,1,1,12,15,11,0,38,16,11,13,15,55,93
36,China,Asia,c,2021,NF,7,6,0,0,1,3,-2,1,2,2,6,11,9
37,Colombia,Americas,c,2021,PF,3,3,10,11,8,0,29,12,6,9,9,36,65
38,Comoros,SSA,c,2021,PF,5,4,5,7,4,0,16,8,6,6,6,26,42
39,Congo (Brazzaville),SSA,c,2021,NF,7,5,0,2,0,0,2,7,4,1,6,18,20
40,Congo (Kinshasa),SSA,c,2021,NF,7,6,1,2,2,0,5,7,3,1,4,15,20
41,Costa Rica,Americas,c,2021,F,1,1,12,15,11,0,38,16,11,13,13,53,91
42,Cote d'Ivoire,SSA,c,2021,PF,5,4,5,7,4,0,16,9,6,6,7,28,44
43,Crimea,Eurasia,t,2021,NF,7,6,0,0,0,2,-2,2,1,0,6,9,7
44,Croatia,Europe,c,2021,F,1,2,12,14,10,0,36,13,12,11,13,49,85
45,Cuba,Americas,c,2021,NF,7,6,0,0,1,0,1,4,0,2,6,12,13
46,Cyprus,Europe,c,2021,F,1,1,12,15,11,0,38,15,12,15,14,56,94
47,Czech Republic,Europe,c,2021,F,1,1,12,15,9,0,36,14,12,14,15,55,91
48,Denmark,Europe,c,2021,F,1,1,12,16,12,0,40,16,12,14,15,57,97
49,Djibouti,SSA,c,2021,NF,7,5,2,3,0,0,5,6,3,4,6,19,24
50,Dominica,Americas,c,2021,F,1,1,11,16,10,0,37,15,11,15,15,56,93
51,Dominican Republic,Americas,c,2021,PF,3,3,9,10,7,0,26,14,10,8,9,41,67
52,Eastern Donbas,Eurasia,t,2021,NF,7,7,0,0,0,1,-1,2,0,0,3,5,4
53,Ecuador,Americas,c,2021,PF,3,3,8,12,7,0,27,13,9,8,10,40,67
54,Egypt,MENA,c,2021,NF,6,6,2,2,2,0,6,3,1,2,6,12,18
55,El Salvador,Americas,c,2021,PF,2,4,11,13,6,0,30,11,8,7,7,33,63
56,Equatorial Guinea,SSA,c,2021,NF,7,7,0,0,0,0,0,2,0,0,3,5,5
57,Eritrea,SSA,c,2021,NF,7,7,0,0,1,0,1,0,0,0,1,1,2
58,Estonia,Europe,c,2021,F,1,1,12,15,11,0,38,16,12,14,14,56,94
59,Eswatini,SSA,c,2021,NF,7,5,0,1,0,0,1,5,3,5,5,18,19
60,Ethiopia,SSA,c,2021,NF,6,6,2,4,3,0,9,4,4,2,3,13,22
61,Fiji,Asia,c,2021,PF,3,3,8,9,7,0,24,12,7,7,10,36,60
62,Finland,Europe,c,2021,F,1,1,12,16,12,0,40,16,12,16,16,60,100
63,France,Europe,c,2021,F,1,2,12,15,11,0,38,14,11,13,14,52,90
64,Gabon,SSA,c,2021,NF,7,5,0,2,1,0,3,8,3,3,5,19,22
65,Gaza Strip,MENA,t,2021,NF,7,6,0,2,1,0,3,4,2,0,2,8,11
66,Georgia,Eurasia,c,2021,PF,4,3,7,9,7,0,23,10,7,8,12,37,60
67,Germany,Europe,c,2021,F,1,1,12,15,12,0,39,14,12,14,15,55,94
68,Ghana,SSA,c,2021,F,2,2,12,13,10,0,35,14,11,11,11,47,82
69,Greece,Europe,c,2021,F,1,2,12,15,10,0,37,14,11,11,14,50,87
70,Grenada,Americas,c,2021,F,1,2,11,16,10,0,37,15,11,13,13,52,89
71,Guatemala,Americas,c,2021,PF,4,4,7,10,4,0,21,11,6,6,8,31,52
72,Guinea,SSA,c,2021,PF,5,5,4,7,3,0,14,10,4,4,6,24,38
73,Guinea-Bissau,SSA,c,2021,PF,5,4,7,8,2,0,17,10,7,5,5,27,44
74,Guyana,Americas,c,2021,F,2,3,9,13,8,0,30,15,11,8,9,43,73
75,Haiti,Americas,c,2021,PF,5,5,4,7,4,0,15,10,3,4,5,22,37
76,Honduras,Americas,c,2021,PF,4,5,7,8,4,0,19,9,4,4,8,25,44
77,Hong Kong,Asia,t,2021,PF,5,3,2,7,6,0,15,9,6,9,13,37,52
78,Hungary,Europe,c,2021,PF,3,3,9,11,6,0,26,10,10,10,13,43,69
79,Iceland,Europe,c,2021,F,1,1,12,15,10,0,37,15,12,15,15,57,94
80,India,Asia,c,2021,PF,2,4,12,13,9,0,34,9,7,8,9,33,67
81,Indian Kashmir,Asia,t,2021,NF,6,5,2,3,2,0,7,6,3,4,7,20,27
82,Indonesia,Asia,c,2021,PF,2,4,11,13,6,0,30,9,6,5,9,29,59
83,Iran,MENA,c,2021,NF,6,6,3,2,1,0,6,2,1,3,4,10,16
84,Iraq,MENA,c,2021,NF,5,6,8,7,2,1,16,4,4,1,4,13,29
85,Ireland,Europe,c,2021,F,1,1,12,16,11,0,39,16,12,14,16,58,97
86,Israel,MENA,c,2021,F,2,3,12,13,8,0,33,12,9,11,11,43,76
87,Italy,Europe,c,2021,F,1,1,12,14,10,0,36,15,12,13,14,54,90
88,Jamaica,Americas,c,2021,F,2,2,12,13,9,0,34,15,11,9,11,46,80
89,Japan,Asia,c,2021,F,1,1,12,16,12,0,40,15,12,15,14,56,96
90,Jordan,MENA,c,2021,NF,6,5,2,6,3,0,11,7,1,7,8,23,34
91,Kazakhstan,Eurasia,c,2021,NF,7,5,1,3,1,0,5,4,2,4,8,18,23
92,Kenya,SSA,c,2021,PF,4,4,6,8,5,0,19,10,7,5,7,29,48
93,Kiribati,Asia,c,2021,F,1,1,12,15,10,0,37,16,12,15,13,56,93
94,Kosovo,Europe,c,2021,PF,4,4,8,10,5,0,23,9,8,6,8,31,54
95,Kuwait,MENA,c,2021,PF,5,5,3,7,4,0,14,6,4,7,6,23,37
96,Kyrgyzstan,Eurasia,c,2021,NF,7,5,2,3,0,1,4,10,5,2,7,24,28
97,Laos,Asia,c,2021,NF,7,6,0,0,2,0,2,3,0,2,6,11,13
98,Latvia,Europe,c,2021,F,1,2,12,15,10,0,37,14,12,12,14,52,89
99,Lebanon,MENA,c,2021,PF,5,4,5,7,1,0,13,11,8,5,6,30,43
100,Lesotho,SSA,c,2021,PF,3,3,10,11,6,0,27,12,7,8,9,36,63
101,Liberia,SSA,c,2021,PF,3,4,8,12,7,0,27,11,7,6,9,33,60
102,Libya,MENA,c,2021,NF,7,6,0,1,0,0,1,4,2,0,2,8,9
103,Liechtenstein,Europe,c,2021,F,2,1,10,13,10,0,33,16,12,14,15,57,90
104,Lithuania,Europe,c,2021,F,1,2,12,16,10,0,38,15,11,12,14,52,90
105,Luxembourg,Europe,c,2021,F,1,1,12,16,10,0,38,16,12,15,16,59,97
106,Madagascar,SSA,c,2021,PF,3,4,9,11,7,0,27,10,8,7,8,33,60
107,Malawi,SSA,c,2021,PF,3,3,9,12,8,0,29,13,8,9,7,37,66
108,Malaysia,Asia,c,2021,PF,4,4,6,9,6,0,21,8,6,7,9,30,51
109,Maldives,Asia,c,2021,PF,4,5,7,8,4,0,19,3,5,6,7,21,40
110,Mali,SSA,c,2021,NF,6,5,2,5,2,0,9,10,6,4,4,24,33
111,Malta,Europe,c,2021,F,2,1,12,14,9,0,35,14,12,15,14,55,90
112,Marshall Islands,Asia,c,2021,F,1,1,12,16,10,0,38,16,11,15,13,55,93
113,Mauritania,SSA,c,2021,PF,5,5,6,4,4,0,14,9,4,4,4,21,35
114,Mauritius,SSA,c,2021,F,1,2,12,15,10,0,37,14,11,13,12,50,87
115,Mexico,Americas,c,2021,PF,3,4,9,13,5,0,27,13,7,5,9,34,61
116,Micronesia,Asia,c,2021,F,1,1,12,15,10,0,37,16,11,15,13,55,92
117,Moldova,Eurasia,c,2021,PF,3,3,9,12,5,0,26,12,8,6,9,35,61
118,Monaco,Europe,c,2021,F,3,1,8,10,8,0,26,16,12,14,15,57,83
119,Mongolia,Asia,c,2021,F,1,2,11,16,9,0,36,14,11,11,12,48,84
120,Montenegro,Europe,c,2021,PF,3,3,9,10,5,0,24,10,9,9,11,39,63
121,Morocco,MENA,c,2021,PF,5,5,5,5,3,0,13,7,5,5,7,24,37
122,Mozambique,SSA,c,2021,PF,5,4,3,7,4,0,14,9,6,6,8,29,43
123,Myanmar,Asia,c,2021,NF,5,6,5,8,4,4,13,5,5,1,4,15,28
124,Nagorno-Karabakh,Eurasia,t,2021,PF,5,5,7,7,3,1,16,7,5,3,4,19,35
125,Namibia,SSA,c,2021,F,2,2,11,12,8,0,31,14,11,11,10,46,77
126,Nauru,Asia,c,2021,F,2,3,12,14,8,0,34,13,9,9,12,43,77
127,Nepal,Asia,c,2021,PF,3,4,10,10,5,0,25,10,7,6,8,31,56
128,Netherlands,Europe,c,2021,F,1,1,12,16,12,0,40,16,12,15,15,58,98
129,New Zealand,Asia,c,2021,F,1,1,12,16,12,0,40,16,12,15,16,59,99
130,Nicaragua,Americas,c,2021,NF,6,5,3,4,3,0,10,7,2,3,8,20,30
131,Niger,SSA,c,2021,PF,4,4,6,8,6,0,20,10,6,6,6,28,48
132,Nigeria,SSA,c,2021,PF,4,5,6,10,5,0,21,9,6,4,5,24,45
133,North Korea,Asia,c,2021,NF,7,7,0,0,0,0,0,0,0,0,3,3,3
134,North Macedonia,Europe,c,2021,PF,3,3,9,11,7,0,27,12,8,9,10,39,66
135,Northern Cyprus,Europe,t,2021,F,3,2,9,12,7,0,28,15,11,13,11,50,78
136,Norway,Europe,c,2021,F,1,1,12,16,12,0,40,16,12,16,16,60,100
137,Oman,MENA,c,2021,NF,6,5,2,2,2,0,6,5,3,4,5,17,23
138,Pakistan,Asia,c,2021,PF,5,5,5,6,4,0,15,6,6,4,6,22,37
139,Pakistani Kashmir,Asia,t,2021,NF,6,5,4,4,3,2,9,6,4,3,6,19,28
140,Palau,Asia,c,2021,F,1,1,12,15,10,0,37,16,11,15,13,55,92
141,Panama,Americas,c,2021,F,2,2,12,15,8,0,35,15,11,10,12,48,83
142,Papua New Guinea,Asia,c,2021,PF,4,3,7,13,3,0,23,14,10,7,8,39,62
143,Paraguay,Americas,c,2021,PF,3,3,10,12,6,0,28,12,8,7,10,37,65
144,Peru,Americas,c,2021,PF,3,3,10,13,6,0,29,15,8,8,11,42,71
145,Philippines,Asia,c,2021,PF,3,4,9,10,6,0,25,12,6,3,10,31,56
146,Poland,Europe,c,2021,F,2,2,10,16,8,0,34,13,10,11,14,48,82
147,Portugal,Europe,c,2021,F,1,1,12,16,11,0,39,16,12,14,15,57,96
148,Qatar,MENA,c,2021,NF,6,5,2,2,3,0,7,7,2,5,4,18,25
149,Romania,Europe,c,2021,F,2,2,12,14,9,0,35,13,11,12,12,48,83
150,Russia,Eurasia,c,2021,NF,7,6,0,3,2,0,5,3,3,2,7,15,20
151,Rwanda,SSA,c,2021,NF,6,6,2,2,4,0,8,3,2,2,6,13,21
152,Samoa,Asia,c,2021,F,2,2,9,12,9,0,30,14,11,14,12,51,81
153,San Marino,Europe,c,2021,F,1,1,12,15,11,0,38,15,12,13,15,55,93
154,Sao Tome and Principe,SSA,c,2021,F,2,2,11,15,9,0,35,15,11,12,11,49,84
155,Saudi Arabia,MENA,c,2021,NF,7,7,0,0,1,0,1,2,0,2,2,6,7
156,Senegal,SSA,c,2021,PF,3,3,9,12,8,0,29,13,9,9,11,42,71
157,Serbia,Europe,c,2021,PF,4,3,7,10,5,0,22,12,9,9,12,42,64
158,Seychelles,SSA,c,2021,F,2,3,12,13,9,0,34,12,9,11,11,43,77
159,Sierra Leone,SSA,c,2021,PF,3,3,10,11,7,0,28,12,6,9,10,37,65
160,Singapore,Asia,c,2021,PF,4,4,4,8,7,0,19,8,3,7,11,29,48
161,Slovakia,Europe,c,2021,F,1,1,12,15,10,0,37,15,12,12,14,53,90
162,Slovenia,Europe,c,2021,F,1,1,12,16,11,0,39,15,12,15,14,56,95
163,Solomon Islands,Asia,c,2021,F,2,2,9,14,7,0,30,16,10,11,12,49,79
164,Somalia,SSA,c,2021,NF,7,7,0,1,0,0,1,3,3,0,0,6,7
165,Somaliland,SSA,t,2021,PF,4,5,5,9,4,0,18,6,5,7,6,24,42
166,South Africa,SSA,c,2021,F,2,2,12,13,8,0,33,15,12,9,10,46,79
167,South Korea,Asia,c,2021,F,2,2,11,13,9,0,33,14,11,12,13,50,83
168,South Ossetia,Eurasia,t,2021,NF,7,6,2,2,0,2,2,3,2,1,2,8,10
169,South Sudan,SSA,c,2021,NF,7,7,1,1,0,4,-2,2,2,0,0,4,2
170,Spain,Europe,c,2021,F,1,1,12,16,9,0,37,14,11,13,15,53,90
171,Sri Lanka,Asia,c,2021,PF,4,4,9,10,5,1,23,8,9,8,8,33,56
172,St. Kitts and Nevis,Americas,c,2021,F,2,1,10,15,10,0,35,16,12,13,13,54,89
173,St. Lucia,Americas,c,2021,F,1,1,11,16,10,0,37,15,12,13,14,54,91
174,St. Vincent and the Grenadines,Americas,c,2021,F,1,1,11,15,10,0,36,15,12,14,14,55,91
175,Sudan,SSA,c,2021,NF,7,6,0,4,0,2,2,7,4,1,3,15,17
176,Suriname,Americas,c,2021,F,2,2,11,14,9,0,34,15,11,9,10,45,79
177,Sweden,Europe,c,2021,F,1,1,12,16,12,0,40,16,12,16,16,60,100
178,Switzerland,Europe,c,2021,F,1,1,12,15,12,0,39,15,12,15,15,57,96
179,Syria,MENA,c,2021,NF,7,7,0,0,0,3,-3,3,0,0,1,4,1
180,Taiwan,Asia,c,2021,F,1,1,12,15,11,0,38,16,11,15,14,56,94
181,Tajikistan,Eurasia,c,2021,NF,7,6,0,0,0,0,0,1,2,1,4,8,8
182,Tanzania,SSA,c,2021,PF,5,5,3,5,4,0,12,7,4,4,7,22,34
183,Thailand,Asia,c,2021,NF,7,5,1,2,2,0,5,6,4,5,10,25,30
184,The Gambia,SSA,c,2021,PF,4,4,7,9,4,0,20,8,6,6,6,26,46
185,Tibet,Asia,t,2021,NF,7,7,0,0,1,3,-2,0,0,0,3,3,1
186,Timor-Leste,Asia,c,2021,F,2,3,11,14,8,0,33,14,8,8,9,39,72
187,Togo,SSA,c,2021,PF,5,4,4,6,5,0,15,9,6,6,7,28,43
188,Tonga,Asia,c,2021,F,2,2,9,14,7,0,30,14,10,12,13,49,79
189,Transnistria,Eurasia,t,2021,NF,6,6,2,4,2,0,8,4,1,2,5,12,20
190,Trinidad and Tobago,Americas,c,2021,F,2,2,11,13,9,0,33,16,11,9,13,49,82
191,Tunisia,MENA,c,2021,F,2,3,12,14,6,0,32,12,8,9,10,39,71
192,Turkey,Europe,c,2021,NF,5,6,5,8,3,0,16,5,3,3,5,16,32
193,Turkmenistan,Eurasia,c,2021,NF,7,7,0,0,0,0,0,0,0,0,2,2,2
194,Tuvalu,Asia,c,2021,F,1,1,12,15,10,0,37,16,12,15,13,56,93
195,Uganda,SSA,c,2021,NF,6,5,3,5,3,0,11,8,4,4,7,23,34
196,Ukraine,Eurasia,c,2021,PF,3,4,9,12,5,0,26,11,7,6,10,34,60
197,United Arab Emirates,MENA,c,2021,NF,7,6,1,2,2,0,5,3,2,3,4,12,17
198,United Kingdom,Europe,c,2021,F,1,1,12,16,11,0,39,14,12,13,15,54,93
199,United States,Americas,c,2021,F,2,2,10,14,8,0,32,15,10,11,15,51,83
200,Uruguay,Americas,c,2021,F,1,1,12,16,12,0,40,16,12,15,15,58,98
201,Uzbekistan,Eurasia,c,2021,NF,7,6,1,0,1,0,2,3,1,1,4,9,11
202,Vanuatu,Asia,c,2021,F,2,2,10,15,8,0,33,14,11,13,11,49,82
203,Venezuela,Americas,c,2021,NF,7,6,0,1,0,0,1,6,2,1,4,13,14
204,Vietnam,Asia,c,2021,NF,7,6,0,1,2,0,3,3,1,4,8,16,19
205,West Bank,MENA,t,2021,NF,7,5,1,4,2,3,4,7,5,4,5,21,25
206,Western Sahara,MENA,t,2021,NF,7,7,0,0,0,3,-3,3,0,0,4,7,4
207,Yemen,MENA,c,2021,NF,7,6,0,1,0,0,1,3,3,2,2,10,11
208,Zambia,SSA,c,2021,PF,4,4,6,10,4,0,20,9,7,8,8,32,52
209,Zimbabwe,SSA,c,2021,NF,6,5,3,5,3,0,11,7,3,2,5,17,28
210,Abkhazia,Eurasia,t,2020,PF,5,5,5,8,4,0,17,8,6,4,5,23,40
211,Afghanistan,Asia,c,2020,NF,5,6,3,7,3,0,13,6,4,2,2,14,27
212,Albania,Europe,c,2020,PF,3,3,8,12,7,0,27,13,9,9,9,40,67
213,Algeria,MENA,c,2020,NF,6,5,3,4,3,0,10,7,4,6,7,24,34
214,Andorra,Europe,c,2020,F,1,1,12,15,12,0,39,14,11,15,15,55,94
215,Angola,SSA,c,2020,NF,6,5,3,6,2,0,11,7,6,5,3,21,32
216,Antigua and Barbuda,Americas,c,2020,F,2,2,12,13,8,0,33,15,10,14,13,52,85
217,Argentina,Americas,c,2020,F,2,2,11,16,8,0,35,15,11,10,14,50,85
218,Armenia,Eurasia,c,2020,PF,4,4,6,10,5,0,21,9,8,6,9,32,53
219,Australia,Asia,c,2020,F,1,1,12,16,12,0,40,15,12,15,15,57,97
220,Austria,Europe,c,2020,F,1,1,12,15,10,0,37,14,12,15,15,56,93
221,Azerbaijan,Eurasia,c,2020,NF,7,6,0,2,0,0,2,2,1,0,5,8,10
222,Bahamas,Americas,c,2020,F,1,1,12,16,10,0,38,15,12,13,13,53,91
223,Bahrain,MENA,c,2020,NF,7,6,2,0,2,3,1,2,1,1,6,10,11
224,Bangladesh,Asia,c,2020,PF,5,5,4,7,4,0,15,6,5,4,9,24,39
225,Barbados,Americas,c,2020,F,1,1,12,16,10,0,38,16,12,14,15,57,95
226,Belarus,Eurasia,c,2020,NF,7,6,0,3,2,0,5,2,3,2,7,14,19
227,Belgium,Europe,c,2020,F,1,1,12,16,11,0,39,15,12,15,15,57,96
228,Belize,Americas,c,2020,F,2,2,12,14,9,0,35,15,11,12,13,51,86
229,Benin,SSA,c,2020,PF,4,2,5,9,7,0,21,15,9,11,10,45,66
230,Bhutan,Asia,c,2020,PF,3,4,10,11,9,1,29,9,5,8,8,30,59
231,Bolivia,Americas,c,2020,PF,3,3,8,10,7,0,25,14,8,6,10,38,63
232,Bosnia and Herzegovina,Europe,c,2020,PF,4,4,6,9,4,0,19,10,7,7,10,34,53
233,Botswana,SSA,c,2020,F,3,2,10,10,8,0,28,12,10,11,11,44,72
234,Brazil,Americas,c,2020,F,2,2,10,14,7,0,31,14,9,8,13,44,75
235,Brunei,Asia,c,2020,NF,6,5,0,3,4,0,7,6,3,5,7,21,28
236,Bulgaria,Europe,c,2020,F,2,2,11,14,9,0,34,13,11,10,12,46,80
237,Burkina Faso,SSA,c,2020,PF,4,4,7,10,6,0,23,11,8,6,8,33,56
238,Burundi,SSA,c,2020,NF,7,6,0,3,0,0,3,4,1,1,4,10,13
239,Cabo Verde,SSA,c,2020,F,1,1,12,16,10,0,38,16,11,14,13,54,92
240,Cambodia,Asia,c,2020,NF,7,5,1,2,2,0,5,8,3,3,6,20,25
241,Cameroon,SSA,c,2020,NF,6,6,1,3,3,0,7,4,2,1,4,11,18
242,Canada,Americas,c,2020,F,1,1,12,16,12,0,40,15,12,15,16,58,98
243,Central African Republic,SSA,c,2020,NF,7,7,3,2,0,1,4,4,1,1,0,6,10
244,Chad,SSA,c,2020,NF,7,6,1,1,1,0,3,6,4,1,3,14,17
245,Chile,Americas,c,2020,F,1,2,12,15,11,0,38,15,10,13,14,52,90
246,China,Asia,c,2020,NF,7,6,0,0,2,3,-1,1,2,2,6,11,10
247,Colombia,Americas,c,2020,PF,3,3,10,11,8,0,29,12,6,9,10,37,66
248,Comoros,SSA,c,2020,PF,4,4,6,8,4,0,18,8,6,6,6,26,44
249,Congo (Brazzaville),SSA,c,2020,NF,7,5,0,2,0,0,2,7,4,1,6,18,20
250,Congo (Kinshasa),SSA,c,2020,NF,7,6,1,2,1,0,4,7,3,0,4,14,18
251,Costa Rica,Americas,c,2020,F,1,1,12,15,11,0,38,16,11,13,13,53,91
252,Cote d'Ivoire,SSA,c,2020,PF,4,4,7,8,4,0,19,11,8,6,7,32,51
253,Crimea,Eurasia,t,2020,NF,7,6,0,0,0,2,-2,3,1,0,6,10,8
254,Croatia,Europe,c,2020,F,1,2,12,14,10,0,36,13,12,11,13,49,85
255,Cuba,Americas,c,2020,NF,7,6,0,0,1,0,1,5,0,2,6,13,14
256,Cyprus,Europe,c,2020,F,1,1,12,15,11,0,38,15,12,15,14,56,94
257,Czech Republic,Europe,c,2020,F,1,1,12,15,9,0,36,14,12,14,15,55,91
258,Denmark,Europe,c,2020,F,1,1,12,16,12,0,40,16,12,14,15,57,97
259,Djibouti,SSA,c,2020,NF,7,5,2,3,0,0,5,6,3,4,6,19,24
260,Dominica,Americas,c,2020,F,1,1,11,16,10,0,37,15,11,15,15,56,93
261,Dominican Republic,Americas,c,2020,PF,3,3,9,10,7,0,26,14,10,8,9,41,67
262,Eastern Donbas,Eurasia,t,2020,NF,7,7,0,0,0,1,-1,2,0,0,4,6,5
263,Ecuador,Americas,c,2020,PF,3,3,8,12,7,0,27,12,8,8,10,38,65
264,Egypt,MENA,c,2020,NF,6,6,2,3,2,0,7,4,1,3,6,14,21
265,El Salvador,Americas,c,2020,PF,2,4,11,13,8,0,32,11,8,7,8,34,66
266,Equatorial Guinea,SSA,c,2020,NF,7,7,0,0,0,0,0,3,0,0,3,6,6
267,Eritrea,SSA,c,2020,NF,7,7,0,0,1,0,1,0,0,0,1,1,2
268,Estonia,Europe,c,2020,F,1,1,12,15,11,0,38,16,12,14,14,56,94
269,Eswatini,SSA,c,2020,NF,7,5,0,1,0,0,1,5,3,5,5,18,19
270,Ethiopia,SSA,c,2020,NF,6,6,2,5,3,0,10,4,4,2,4,14,24
271,Fiji,Asia,c,2020,PF,3,3,8,9,7,0,24,12,7,7,10,36,60
272,Finland,Europe,c,2020,F,1,1,12,16,12,0,40,16,12,16,16,60,100
273,France,Europe,c,2020,F,1,2,12,15,11,0,38,14,11,13,14,52,90
274,Gabon,SSA,c,2020,NF,7,5,0,2,1,0,3,8,3,3,5,19,22
275,Gaza Strip,MENA,t,2020,NF,7,6,0,2,1,0,3,4,2,0,2,8,11
276,Georgia,Eurasia,c,2020,PF,3,3,8,9,7,0,24,10,7,8,12,37,61
277,Germany,Europe,c,2020,F,1,1,12,15,12,0,39,14,12,14,15,55,94
278,Ghana,SSA,c,2020,F,2,2,12,13,10,0,35,14,11,11,11,47,82
279,Greece,Europe,c,2020,F,1,2,12,15,10,0,37,14,12,11,14,51,88
280,Grenada,Americas,c,2020,F,1,2,11,16,10,0,37,15,11,13,13,52,89
281,Guatemala,Americas,c,2020,PF,4,4,7,10,4,0,21,11,6,6,8,31,52
282,Guinea,SSA,c,2020,PF,5,5,5,7,3,0,15,11,4,4,6,25,40
283,Guinea-Bissau,SSA,c,2020,PF,5,4,7,8,2,0,17,11,8,5,5,29,46
284,Guyana,Americas,c,2020,F,2,3,10,13,8,0,31,15,11,8,9,43,74
285,Haiti,Americas,c,2020,PF,5,5,5,7,4,0,16,10,3,4,5,22,38
286,Honduras,Americas,c,2020,PF,4,4,7,8,4,0,19,9,4,5,8,26,45
287,Hong Kong,Asia,t,2020,PF,5,3,2,8,6,0,16,10,6,10,13,39,55
288,Hungary,Europe,c,2020,PF,3,3,9,11,7,0,27,10,10,10,13,43,70
289,Iceland,Europe,c,2020,F,1,1,12,15,10,0,37,15,12,15,15,57,94
290,India,Asia,c,2020,F,2,3,12,13,9,0,34,10,8,9,10,37,71
291,Indian Kashmir,Asia,t,2020,NF,6,5,2,4,2,0,8,6,3,4,7,20,28
292,Indonesia,Asia,c,2020,PF,2,4,11,13,6,0,30,10,7,5,9,31,61
293,Iran,MENA,c,2020,NF,6,6,3,2,2,0,7,2,1,3,4,10,17
294,Iraq,MENA,c,2020,NF,5,6,8,8,2,1,17,5,4,1,4,14,31
295,Ireland,Europe,c,2020,F,1,1,12,16,11,0,39,16,12,14,16,58,97
296,Israel,MENA,c,2020,F,2,3,12,13,8,0,33,12,9,11,11,43,76
297,Italy,Europe,c,2020,F,1,1,12,14,10,0,36,15,12,12,14,53,89
298,Jamaica,Americas,c,2020,F,2,2,12,13,9,0,34,15,10,8,11,44,78
299,Japan,Asia,c,2020,F,1,1,12,16,12,0,40,15,12,15,14,56,96
300,Jordan,MENA,c,2020,PF,5,5,3,6,3,0,12,7,3,7,8,25,37
301,Kazakhstan,Eurasia,c,2020,NF,7,5,1,3,1,0,5,4,2,4,8,18,23
302,Kenya,SSA,c,2020,PF,4,4,6,8,5,0,19,10,7,5,7,29,48
303,Kiribati,Asia,c,2020,F,1,1,12,15,10,0,37,16,12,15,13,56,93
304,Kosovo,Europe,c,2020,PF,3,4,9,11,5,0,25,9,8,6,8,31,56
305,Kuwait,MENA,c,2020,PF,5,5,2,7,4,0,13,6,4,7,6,23,36
306,Kyrgyzstan,Eurasia,c,2020,PF,5,4,4,5,4,1,12,10,6,4,7,27,39
307,Laos,Asia,c,2020,NF,7,6,0,0,2,0,2,4,0,2,6,12,14
308,Latvia,Europe,c,2020,F,1,2,12,15,10,0,37,14,12,12,14,52,89
309,Lebanon,MENA,c,2020,PF,5,4,5,7,2,0,14,11,8,5,6,30,44
310,Lesotho,SSA,c,2020,PF,3,3,10,11,6,0,27,12,7,8,9,36,63
311,Liberia,SSA,c,2020,PF,3,4,8,12,7,0,27,11,7,6,9,33,60
312,Libya,MENA,c,2020,NF,7,6,0,1,0,0,1,4,2,0,2,8,9
313,Liechtenstein,Europe,c,2020,F,2,1,10,13,10,0,33,16,12,14,15,57,90
314,Lithuania,Europe,c,2020,F,1,1,12,16,10,0,38,16,11,12,14,53,91
315,Luxembourg,Europe,c,2020,F,1,1,12,16,10,0,38,16,12,16,16,60,98
316,Madagascar,SSA,c,2020,PF,3,3,9,11,6,0,26,11,9,7,8,35,61
317,Malawi,SSA,c,2020,PF,3,3,8,12,6,0,26,13,7,9,7,36,62
318,Malaysia,Asia,c,2020,PF,4,4,6,9,6,0,21,9,6,7,9,31,52
319,Maldives,Asia,c,2020,PF,4,5,7,7,4,0,18,3,6,6,7,22,40
320,Mali,SSA,c,2020,PF,5,5,5,8,4,0,17,10,6,4,4,24,41
321,Malta,Europe,c,2020,F,2,1,12,14,9,0,35,14,12,15,14,55,90
322,Marshall Islands,Asia,c,2020,F,1,1,12,16,10,0,38,16,11,15,13,55,93
323,Mauritania,SSA,c,2020,PF,5,5,6,3,4,0,13,9,4,4,4,21,34
324,Mauritius,SSA,c,2020,F,1,2,12,15,10,0,37,15,12,13,12,52,89
325,Mexico,Americas,c,2020,PF,3,3,9,13,5,0,27,13,7,5,10,35,62
326,Micronesia,Asia,c,2020,F,1,1,12,15,10,0,37,16,11,15,13,55,92
327,Moldova,Eurasia,c,2020,PF,3,4,9,12,5,0,26,11,8,6,9,34,60
328,Monaco,Europe,c,2020,F,3,1,8,10,8,0,26,16,12,14,15,57,83
329,Mongolia,Asia,c,2020,F,1,2,11,16,9,0,36,14,11,11,12,48,84
330,Montenegro,Europe,c,2020,PF,4,3,8,9,5,0,22,11,9,9,11,40,62
331,Morocco,MENA,c,2020,PF,5,5,5,5,3,0,13,7,5,5,7,24,37
332,Mozambique,SSA,c,2020,PF,5,4,3,7,4,0,14,9,6,7,9,31,45
333,Myanmar,Asia,c,2020,NF,5,6,5,9,4,4,14,5,6,1,4,16,30
334,Nagorno-Karabakh,Eurasia,t,2020,PF,5,5,4,6,3,0,13,7,5,4,5,21,34
335,Namibia,SSA,c,2020,F,2,2,11,12,8,0,31,14,11,11,10,46,77
336,Nauru,Asia,c,2020,F,2,3,12,14,8,0,34,13,9,9,12,43,77
337,Nepal,Asia,c,2020,PF,3,4,10,10,5,0,25,10,7,6,8,31,56
338,Netherlands,Europe,c,2020,F,1,1,12,16,12,0,40,16,12,15,16,59,99
339,New Zealand,Asia,c,2020,F,1,1,12,16,12,0,40,16,12,14,15,57,97
340,Nicaragua,Americas,c,2020,NF,6,5,3,4,3,0,10,7,2,4,8,21,31
341,Niger,SSA,c,2020,PF,4,4,6,8,6,0,20,10,6,6,6,28,48
342,Nigeria,SSA,c,2020,PF,4,5,6,10,6,0,22,9,7,4,5,25,47
343,North Korea,Asia,c,2020,NF,7,7,0,0,0,0,0,0,0,0,3,3,3
344,North Macedonia,Europe,c,2020,PF,3,3,7,11,6,0,24,12,8,9,10,39,63
345,Northern Cyprus,Europe,t,2020,F,2,2,11,13,7,0,31,15,11,13,11,50,81
346,Norway,Europe,c,2020,F,1,1,12,16,12,0,40,16,12,16,16,60,100
347,Oman,MENA,c,2020,NF,6,5,2,2,2,0,6,5,3,4,5,17,23
348,Pakistan,Asia,c,2020,PF,5,5,5,6,5,0,16,6,6,4,6,22,38
349,Pakistani Kashmir,Asia,t,2020,NF,6,5,4,4,3,2,9,6,4,3,6,19,28
350,Palau,Asia,c,2020,F,1,1,12,15,10,0,37,16,11,15,13,55,92
351,Panama,Americas,c,2020,F,1,2,12,15,9,0,36,15,11,10,12,48,84
352,Papua New Guinea,Asia,c,2020,PF,4,3,7,13,3,0,23,14,10,7,8,39,62
353,Paraguay,Americas,c,2020,PF,3,3,10,12,6,0,28,12,8,7,10,37,65
354,Peru,Americas,c,2020,F,2,3,11,13,6,0,30,15,8,8,11,42,72
355,Philippines,Asia,c,2020,PF,3,4,9,10,6,0,25,14,7,3,10,34,59
356,Poland,Europe,c,2020,F,2,2,11,16,8,0,35,14,10,11,14,49,84
357,Portugal,Europe,c,2020,F,1,1,12,16,11,0,39,16,12,14,15,57,96
358,Qatar,MENA,c,2020,NF,6,5,2,2,3,0,7,7,2,5,4,18,25
359,Romania,Europe,c,2020,F,2,2,12,14,9,0,35,13,11,12,12,48,83
360,Russia,Eurasia,c,2020,NF,7,6,0,3,2,0,5,3,3,2,7,15,20
361,Rwanda,SSA,c,2020,NF,6,6,2,2,4,0,8,3,2,2,7,14,22
362,Samoa,Asia,c,2020,F,2,2,9,12,9,0,30,14,11,14,12,51,81
363,San Marino,Europe,c,2020,F,1,1,12,15,11,0,38,15,12,15,15,57,95
364,Sao Tome and Principe,SSA,c,2020,F,2,2,11,15,9,0,35,15,11,12,11,49,84
365,Saudi Arabia,MENA,c,2020,NF,7,7,0,0,1,0,1,2,0,2,2,6,7
366,Senegal,SSA,c,2020,PF,3,3,9,12,8,0,29,13,9,9,11,42,71
367,Serbia,Europe,c,2020,PF,4,3,8,10,5,0,23,12,10,9,12,43,66
368,Seychelles,SSA,c,2020,PF,3,3,10,11,8,0,29,12,9,11,11,43,72
369,Sierra Leone,SSA,c,2020,PF,3,3,10,11,7,0,28,12,6,9,10,37,65
370,Singapore,Asia,c,2020,PF,4,4,4,8,7,0,19,8,4,7,12,31,50
371,Slovakia,Europe,c,2020,F,1,2,12,15,9,0,36,14,12,12,14,52,88
372,Slovenia,Europe,c,2020,F,1,1,12,16,11,0,39,14,12,15,14,55,94
373,Solomon Islands,Asia,c,2020,F,2,2,9,14,7,0,30,16,10,11,12,49,79
374,Somalia,SSA,c,2020,NF,7,7,0,1,0,0,1,3,3,0,0,6,7
375,Somaliland,SSA,t,2020,PF,5,5,5,8,4,0,17,6,5,7,6,24,41
376,South Africa,SSA,c,2020,F,2,2,12,13,8,0,33,15,12,9,10,46,79
377,South Korea,Asia,c,2020,F,2,2,11,13,9,0,33,14,11,12,13,50,83
378,South Ossetia,Eurasia,t,2020,NF,7,6,2,2,0,2,2,3,1,1,3,8,10
379,South Sudan,SSA,c,2020,NF,7,7,1,1,0,4,-2,2,2,0,0,4,2
380,Spain,Europe,c,2020,F,1,1,12,16,10,0,38,14,11,14,15,54,92
381,Sri Lanka,Asia,c,2020,PF,4,4,9,10,5,1,23,8,9,8,8,33,56
382,St. Kitts and Nevis,Americas,c,2020,F,1,1,10,16,10,0,36,15,12,13,13,53,89
383,St. Lucia,Americas,c,2020,F,1,1,11,16,11,0,38,15,12,13,14,54,92
384,St. Vincent and the Grenadines,Americas,c,2020,F,1,1,11,15,10,0,36,15,12,14,14,55,91
385,Sudan,SSA,c,2020,NF,7,6,0,4,0,2,2,5,3,1,1,10,12
386,Suriname,Americas,c,2020,F,2,3,11,14,7,0,32,14,11,8,10,43,75
387,Sweden,Europe,c,2020,F,1,1,12,16,12,0,40,16,12,16,16,60,100
388,Switzerland,Europe,c,2020,F,1,1,12,15,12,0,39,15,12,15,15,57,96
389,Syria,MENA,c,2020,NF,7,7,0,0,0,3,-3,3,0,0,0,3,0
390,Taiwan,Asia,c,2020,F,1,1,12,15,10,0,37,16,11,15,14,56,93
391,Tajikistan,Eurasia,c,2020,NF,7,6,0,0,0,0,0,2,2,1,4,9,9
392,Tanzania,SSA,c,2020,PF,5,5,6,6,5,0,17,7,4,5,7,23,40
393,Thailand,Asia,c,2020,PF,6,4,1,3,2,0,6,6,5,5,10,26,32
394,The Gambia,SSA,c,2020,PF,4,4,7,9,4,0,20,8,6,6,6,26,46
395,Tibet,Asia,t,2020,NF,7,7,0,0,1,3,-2,0,0,0,3,3,1
396,Timor-Leste,Asia,c,2020,F,2,3,11,14,7,0,32,14,8,8,9,39,71
397,Togo,SSA,c,2020,PF,5,4,5,6,5,0,16,9,6,6,7,28,44
398,Tonga,Asia,c,2020,F,2,2,9,14,7,0,30,14,10,12,13,49,79
399,Transnistria,Eurasia,t,2020,NF,6,6,3,4,2,0,9,5,1,2,5,13,22
400,Trinidad and Tobago,Americas,c,2020,F,2,2,11,13,9,0,33,16,11,9,13,49,82
401,Tunisia,MENA,c,2020,F,2,3,12,14,6,0,32,12,7,9,10,38,70
402,Turkey,Europe,c,2020,NF,5,6,5,8,3,0,16,5,3,3,5,16,32
403,Turkmenistan,Eurasia,c,2020,NF,7,7,0,0,0,0,0,0,0,0,2,2,2
404,Tuvalu,Asia,c,2020,F,1,1,12,15,10,0,37,16,12,15,13,56,93
405,Uganda,SSA,c,2020,NF,6,5,3,5,3,0,11,8,4,4,7,23,34
406,Ukraine,Eurasia,c,2020,PF,3,3,9,12,6,0,27,11,7,7,10,35,62
407,United Arab Emirates,MENA,c,2020,NF,7,6,1,2,2,0,5,3,2,3,4,12,17
408,United Kingdom,Europe,c,2020,F,1,1,12,16,11,0,39,14,12,14,15,55,94
409,United States,Americas,c,2020,F,2,1,10,14,9,0,33,16,11,11,15,53,86
410,Uruguay,Americas,c,2020,F,1,1,12,16,12,0,40,16,12,15,15,58,98
411,Uzbekistan,Eurasia,c,2020,NF,7,6,1,0,1,0,2,2,1,1,4,8,10
412,Vanuatu,Asia,c,2020,F,2,2,10,15,8,0,33,14,11,13,11,49,82
413,Venezuela,Americas,c,2020,NF,7,6,0,2,0,0,2,6,2,1,5,14,16
414,Vietnam,Asia,c,2020,NF,7,5,0,1,2,0,3,4,1,4,8,17,20
415,West Bank,MENA,t,2020,NF,7,5,1,4,2,3,4,7,5,4,5,21,25
416,Western Sahara,MENA,t,2020,NF,7,7,0,0,0,3,-3,3,0,0,4,7,4
417,Yemen,MENA,c,2020,NF,7,6,0,1,0,0,1,3,3,2,2,10,11
418,Zambia,SSA,c,2020,PF,4,4,6,10,6,0,22,9,7,8,8,32,54
419,Zimbabwe,SSA,c,2020,PF,5,5,3,6,3,0,12,7,3,2,5,17,29
420,Abkhazia,Eurasia,t,2019,PF,4,5,6,8,4,0,18,8,6,4,5,23,41
421,Afghanistan,Asia,c,2019,NF,5,6,3,7,3,0,13,6,4,2,2,14,27
422,Albania,Europe,c,2019,PF,3,3,8,13,7,0,28,13,9,9,9,40,68
423,Algeria,MENA,c,2019,NF,6,5,3,4,3,0,10,7,4,6,7,24,34
424,Andorra,Europe,c,2019,F,1,1,12,15,12,0,39,14,11,15,15,55,94
425,Angola,SSA,c,2019,NF,6,5,3,6,2,0,11,7,6,4,3,20,31
426,Antigua and Barbuda,Americas,c,2019,F,2,2,12,13,8,0,33,15,9,14,13,51,84
427,Argentina,Americas,c,2019,F,2,2,11,15,8,0,34,15,11,10,14,50,84
428,Armenia,Eurasia,c,2019,PF,4,4,6,10,4,0,20,9,7,6,9,31,51
429,Australia,Asia,c,2019,F,1,1,12,16,12,0,40,16,12,15,15,58,98
430,Austria,Europe,c,2019,F,1,1,12,15,10,0,37,14,12,15,15,56,93
431,Azerbaijan,Eurasia,c,2019,NF,7,6,0,2,0,0,2,2,1,1,5,9,11
432,Bahamas,Americas,c,2019,F,1,1,12,16,10,0,38,15,12,13,13,53,91
433,Bahrain,MENA,c,2019,NF,7,6,2,0,3,3,2,2,1,1,6,10,12
434,Bangladesh,Asia,c,2019,PF,5,5,5,7,5,0,17,6,5,4,9,24,41
435,Barbados,Americas,c,2019,F,1,1,12,16,10,0,38,16,12,15,15,58,96
436,Belarus,Eurasia,c,2019,NF,7,6,0,3,2,0,5,2,3,2,7,14,19
437,Belgium,Europe,c,2019,F,1,1,12,16,11,0,39,15,12,15,15,57,96
438,Belize,Americas,c,2019,F,1,2,12,14,10,0,36,15,10,12,13,50,86
439,Benin,SSA,c,2019,F,2,2,9,15,8,0,32,15,11,11,10,47,79
440,Bhutan,Asia,c,2019,PF,3,4,10,11,9,1,29,9,5,8,8,30,59
441,Bolivia,Americas,c,2019,PF,3,3,10,11,7,0,28,14,9,6,10,39,67
442,Bosnia and Herzegovina,Europe,c,2019,PF,4,4,6,9,4,0,19,10,7,7,10,34,53
443,Botswana,SSA,c,2019,F,3,2,10,10,8,0,28,12,10,11,11,44,72
444,Brazil,Americas,c,2019,F,2,2,10,14,6,0,30,15,9,8,13,45,75
445,Brunei,Asia,c,2019,NF,6,5,0,3,4,0,7,6,3,6,7,22,29
446,Bulgaria,Europe,c,2019,F,2,2,11,14,8,0,33,14,11,10,12,47,80
447,Burkina Faso,SSA,c,2019,PF,4,3,7,10,6,0,23,13,9,7,8,37,60
448,Burundi,SSA,c,2019,NF,7,6,0,3,0,0,3,5,1,1,4,11,14
449,Cambodia,Asia,c,2019,NF,6,5,1,2,3,0,6,8,3,3,6,20,26
450,Cameroon,SSA,c,2019,NF,6,6,1,3,3,0,7,5,2,1,4,12,19
451,Canada,Americas,c,2019,F,1,1,12,16,12,0,40,16,12,15,16,59,99
452,Cape Verde,SSA,c,2019,F,1,1,12,15,10,0,37,15,11,14,13,53,90
453,Central African Republic,SSA,c,2019,NF,7,7,3,2,0,1,4,4,1,0,0,5,9
454,Chad,SSA,c,2019,NF,7,6,1,1,1,0,3,6,4,1,3,14,17
455,Chile,Americas,c,2019,F,1,1,12,15,10,0,37,16,12,14,15,57,94
456,China,Asia,c,2019,NF,7,6,0,0,2,3,-1,2,2,2,6,12,11
457,Colombia,Americas,c,2019,PF,3,3,10,11,8,0,29,12,6,9,10,37,66
458,Comoros,SSA,c,2019,PF,4,4,8,9,4,0,21,10,6,7,6,29,50
459,Congo (Brazzaville),SSA,c,2019,NF,7,5,0,2,0,0,2,7,5,1,6,19,21
460,Congo (Kinshasa),SSA,c,2019,NF,7,6,0,2,1,0,3,7,1,0,4,12,15
461,Costa Rica,Americas,c,2019,F,1,1,12,15,11,0,38,16,11,13,13,53,91
462,Cote d'Ivoire,SSA,c,2019,PF,4,4,7,8,4,0,19,11,8,6,7,32,51
463,Crimea,Eurasia,t,2019,NF,7,6,0,0,0,2,-2,3,1,0,6,10,8
464,Croatia,Europe,c,2019,F,1,2,12,14,10,0,36,13,12,11,13,49,85
465,Cuba,Americas,c,2019,NF,7,6,0,0,1,0,1,5,0,2,6,13,14
466,Cyprus,Europe,c,2019,F,1,1,12,15,11,0,38,15,12,15,14,56,94
467,Czech Republic,Europe,c,2019,F,1,1,12,15,9,0,36,14,12,14,15,55,91
468,Denmark,Europe,c,2019,F,1,1,12,16,12,0,40,16,12,14,15,57,97
469,Djibouti,SSA,c,2019,NF,6,5,2,3,2,0,7,6,3,4,6,19,26
470,Dominica,Americas,c,2019,F,1,1,11,16,10,0,37,15,11,15,15,56,93
471,Dominican Republic,Americas,c,2019,PF,3,3,9,10,7,0,26,14,10,8,9,41,67
472,Ecuador,Americas,c,2019,PF,3,3,7,11,7,0,25,12,9,7,10,38,63
473,Egypt,MENA,c,2019,NF,6,6,2,3,3,0,8,4,1,3,6,14,22
474,El Salvador,Americas,c,2019,F,2,3,11,13,8,0,32,12,8,7,8,35,67
475,Equatorial Guinea,SSA,c,2019,NF,7,7,0,0,0,0,0,3,0,0,3,6,6
476,Eritrea,SSA,c,2019,NF,7,7,0,0,1,0,1,0,0,0,1,1,2
477,Estonia,Europe,c,2019,F,1,1,12,15,11,0,38,16,12,14,14,56,94
478,Ethiopia,SSA,c,2019,NF,6,6,1,3,3,0,7,4,2,2,4,12,19
479,Fiji,Asia,c,2019,PF,3,3,8,9,7,0,24,12,8,7,10,37,61
480,Finland,Europe,c,2019,F,1,1,12,16,12,0,40,16,12,16,16,60,100
481,France,Europe,c,2019,F,1,2,12,15,11,0,38,14,11,13,14,52,90
482,Gabon,SSA,c,2019,NF,7,5,0,2,2,0,4,8,3,3,5,19,23
483,Gaza Strip,MENA,t,2019,NF,7,6,0,2,1,0,3,4,2,0,2,8,11
484,Georgia,Eurasia,c,2019,PF,3,3,8,10,7,0,25,10,8,8,12,38,63
485,Germany,Europe,c,2019,F,1,1,12,15,12,0,39,14,12,14,15,55,94
486,Ghana,SSA,c,2019,F,1,2,12,14,10,0,36,14,11,11,11,47,83
487,Greece,Europe,c,2019,F,1,2,12,15,9,0,36,14,12,11,14,51,87
488,Grenada,Americas,c,2019,F,1,2,11,16,10,0,37,15,11,13,13,52,89
489,Guatemala,Americas,c,2019,PF,4,4,8,10,4,0,22,11,6,6,8,31,53
490,Guinea,SSA,c,2019,PF,5,4,6,8,3,0,17,11,5,4,6,26,43
491,Guinea-Bissau,SSA,c,2019,PF,5,4,6,8,1,0,15,11,7,4,5,27,42
492,Guyana,Americas,c,2019,F,2,3,11,13,8,0,32,15,11,8,9,43,75
493,Haiti,Americas,c,2019,PF,5,5,5,7,5,0,17,10,4,4,6,24,41
494,Honduras,Americas,c,2019,PF,4,4,7,8,5,0,20,9,4,5,8,26,46
495,Hong Kong,Asia,t,2019,PF,5,2,2,7,6,0,15,12,8,11,13,44,59
496,Hungary,Europe,c,2019,PF,3,3,9,11,7,0,27,10,10,10,13,43,70
497,Iceland,Europe,c,2019,F,1,1,12,15,10,0,37,15,12,15,15,57,94
498,India,Asia,c,2019,F,2,3,12,14,9,0,35,11,10,9,10,40,75
499,Indian Kashmir,Asia,t,2019,PF,4,4,9,9,4,0,22,9,5,5,8,27,49
500,Indonesia,Asia,c,2019,PF,2,4,11,13,6,0,30,11,7,5,9,32,62
501,Iran,MENA,c,2019,NF,6,6,3,2,2,0,7,3,1,3,4,11,18
502,Iraq,MENA,c,2019,NF,5,6,8,8,2,1,17,5,5,1,4,15,32
503,Ireland,Europe,c,2019,F,1,1,12,16,11,0,39,16,12,14,16,58,97
504,Israel,MENA,c,2019,F,2,3,12,13,10,0,35,12,9,11,11,43,78
505,Italy,Europe,c,2019,F,1,1,12,14,10,0,36,15,12,12,14,53,89
506,Jamaica,Americas,c,2019,F,2,2,12,13,9,0,34,15,10,8,11,44,78
507,Japan,Asia,c,2019,F,1,1,12,16,12,0,40,15,12,15,14,56,96
508,Jordan,MENA,c,2019,PF,5,5,3,6,3,0,12,7,3,7,8,25,37
509,Kazakhstan,Eurasia,c,2019,NF,7,5,1,3,1,0,5,4,1,4,8,17,22
510,Kenya,SSA,c,2019,PF,4,4,6,8,5,0,19,10,7,5,7,29,48
511,Kiribati,Asia,c,2019,F,1,1,12,15,10,0,37,16,12,15,13,56,93
512,Kosovo,Europe,c,2019,PF,3,4,9,10,5,0,24,9,8,6,7,30,54
513,Kuwait,MENA,c,2019,PF,5,5,2,7,4,0,13,6,4,7,6,23,36
514,Kyrgyzstan,Eurasia,c,2019,PF,5,4,4,5,4,1,12,10,5,4,7,26,38
515,Laos,Asia,c,2019,NF,7,6,0,0,2,0,2,4,0,2,6,12,14
516,Latvia,Europe,c,2019,F,2,2,12,14,9,0,35,14,12,12,14,52,87
517,Lebanon,MENA,c,2019,PF,5,4,5,7,2,0,14,11,8,5,7,31,45
518,Lesotho,SSA,c,2019,PF,3,3,10,11,6,0,27,12,7,8,9,36,63
519,Liberia,SSA,c,2019,PF,3,3,8,12,7,0,27,11,8,7,9,35,62
520,Libya,MENA,c,2019,NF,7,6,0,1,0,0,1,4,2,0,2,8,9
521,Liechtenstein,Europe,c,2019,F,2,1,10,13,10,0,33,16,12,14,15,57,90
522,Lithuania,Europe,c,2019,F,1,1,12,16,10,0,38,16,11,12,14,53,91
523,Luxembourg,Europe,c,2019,F,1,1,12,16,10,0,38,16,12,16,16,60,98
524,Macedonia,Europe,c,2019,PF,4,3,6,10,6,0,22,11,8,8,10,37,59
525,Madagascar,SSA,c,2019,PF,3,4,9,10,5,0,24,10,8,7,7,32,56
526,Malawi,SSA,c,2019,PF,3,3,8,12,6,0,26,14,8,9,7,38,64
527,Malaysia,Asia,c,2019,PF,4,4,6,9,6,0,21,9,6,7,9,31,52
528,Maldives,Asia,c,2019,PF,5,5,5,6,3,0,14,3,6,5,7,21,35
529,Mali,SSA,c,2019,PF,4,4,6,8,4,0,18,10,6,6,4,26,44
530,Malta,Europe,c,2019,F,2,1,12,14,9,0,35,15,12,15,14,56,91
531,Marshall Islands,Asia,c,2019,F,1,1,12,16,10,0,38,16,11,15,13,55,93
532,Mauritania,SSA,c,2019,NF,6,5,5,2,4,0,11,9,4,4,4,21,32
533,Mauritius,SSA,c,2019,F,1,2,12,15,10,0,37,15,12,13,12,52,89
534,Mexico,Americas,c,2019,PF,3,3,9,13,5,0,27,13,7,6,10,36,63
535,Micronesia,Asia,c,2019,F,1,1,12,15,10,0,37,16,11,15,13,55,92
536,Moldova,Eurasia,c,2019,PF,3,4,9,11,4,0,24,11,8,6,9,34,58
537,Monaco,Europe,c,2019,F,3,1,8,10,8,0,26,16,12,14,14,56,82
538,Mongolia,Asia,c,2019,F,1,2,11,16,9,0,36,14,11,12,12,49,85
539,Montenegro,Europe,c,2019,PF,4,3,8,9,6,0,23,11,9,10,12,42,65
540,Morocco,MENA,c,2019,PF,5,5,5,6,3,0,14,7,5,6,7,25,39
541,Mozambique,SSA,c,2019,PF,4,4,5,9,5,0,19,9,7,7,9,32,51
542,Myanmar,Asia,c,2019,PF,5,5,5,8,4,4,13,5,6,1,5,17,30
543,Nagorno-Karabakh,Eurasia,t,2019,PF,5,5,4,5,3,0,12,6,4,4,5,19,31
544,Namibia,SSA,c,2019,F,3,2,10,11,8,0,29,14,11,11,10,46,75
545,Nauru,Asia,c,2019,F,2,2,12,14,8,0,34,13,9,10,12,44,78
546,Nepal,Asia,c,2019,PF,3,4,10,10,5,0,25,9,6,6,8,29,54
547,Netherlands,Europe,c,2019,F,1,1,12,16,12,0,40,16,12,15,16,59,99
548,New Zealand,Asia,c,2019,F,1,1,12,16,12,0,40,16,12,15,15,58,98
549,Nicaragua,Americas,c,2019,NF,6,5,3,4,3,0,10,8,2,4,8,22,32
550,Niger,SSA,c,2019,PF,4,4,6,8,6,0,20,11,6,6,6,29,49
551,Nigeria,SSA,c,2019,PF,3,5,9,10,6,0,25,9,7,4,5,25,50
552,North Korea,Asia,c,2019,NF,7,7,0,0,0,0,0,0,0,0,3,3,3
553,Northern Cyprus,Europe,t,2019,F,2,2,11,13,7,0,31,15,11,13,11,50,81
554,Norway,Europe,c,2019,F,1,1,12,16,12,0,40,16,12,16,16,60,100
555,Oman,MENA,c,2019,NF,6,5,2,2,2,0,6,5,3,4,5,17,23
556,Pakistan,Asia,c,2019,PF,5,5,5,7,5,0,17,6,6,4,6,22,39
557,Pakistani Kashmir,Asia,t,2019,NF,6,5,4,4,3,2,9,6,4,3,6,19,28
558,Palau,Asia,c,2019,F,1,1,12,15,10,0,37,16,11,15,13,55,92
559,Panama,Americas,c,2019,F,1,2,12,15,9,0,36,15,11,10,12,48,84
560,Papua New Guinea,Asia,c,2019,PF,4,3,7,13,3,0,23,14,10,8,9,41,64
561,Paraguay,Americas,c,2019,PF,3,3,10,12,6,0,28,12,8,7,10,37,65
562,Peru,Americas,c,2019,F,2,3,11,13,7,0,31,15,8,8,11,42,73
563,Philippines,Asia,c,2019,PF,3,3,9,10,7,0,26,14,8,3,10,35,61
564,Poland,Europe,c,2019,F,2,2,11,16,8,0,35,14,10,11,14,49,84
565,Portugal,Europe,c,2019,F,1,1,12,16,11,0,39,16,12,14,15,57,96
566,Qatar,MENA,c,2019,NF,6,5,2,2,3,0,7,7,2,5,4,18,25
567,Romania,Europe,c,2019,F,2,2,11,14,9,0,34,13,10,12,12,47,81
568,Russia,Eurasia,c,2019,NF,7,6,0,3,2,0,5,3,3,2,7,15,20
569,Rwanda,SSA,c,2019,NF,6,6,2,2,5,0,9,3,2,2,7,14,23
570,Samoa,Asia,c,2019,F,2,2,9,12,9,0,30,14,11,14,12,51,81
571,San Marino,Europe,c,2019,F,1,1,12,15,11,0,38,15,12,15,15,57,95
572,Sao Tome and Principe,SSA,c,2019,F,2,2,11,14,9,0,34,15,11,12,11,49,83
573,Saudi Arabia,MENA,c,2019,NF,7,7,0,0,1,0,1,2,0,2,2,6,7
574,Senegal,SSA,c,2019,F,2,3,10,12,8,0,30,13,9,9,11,42,72
575,Serbia,Europe,c,2019,PF,3,3,8,10,6,0,24,12,10,9,12,43,67
576,Seychelles,SSA,c,2019,PF,3,3,10,11,7,0,28,12,9,11,11,43,71
577,Sierra Leone,SSA,c,2019,PF,3,3,10,11,7,0,28,12,6,9,10,37,65
578,Singapore,Asia,c,2019,PF,4,4,4,8,7,0,19,9,4,7,12,32,51
579,Slovakia,Europe,c,2019,F,1,2,12,15,9,0,36,14,12,12,14,52,88
580,Slovenia,Europe,c,2019,F,1,1,12,16,11,0,39,14,12,15,14,55,94
581,Solomon Islands,Asia,c,2019,F,2,2,9,14,7,0,30,16,10,11,12,49,79
582,Somalia,SSA,c,2019,NF,7,7,0,1,0,0,1,3,3,0,0,6,7
583,Somaliland,SSA,t,2019,PF,4,5,5,10,4,0,19,6,5,7,6,24,43
584,South Africa,SSA,c,2019,F,2,2,12,13,8,0,33,15,12,9,10,46,79
585,South Korea,Asia,c,2019,F,2,2,11,13,9,0,33,14,11,12,13,50,83
586,South Ossetia,Eurasia,t,2019,NF,7,6,2,2,0,2,2,3,1,1,3,8,10
587,South Sudan,SSA,c,2019,NF,7,7,1,1,0,4,-2,2,2,0,0,4,2
588,Spain,Europe,c,2019,F,1,1,12,16,11,0,39,14,11,15,15,55,94
589,Sri Lanka,Asia,c,2019,PF,3,4,9,10,6,1,24,8,8,8,8,32,56
590,St. Kitts and Nevis,Americas,c,2019,F,1,1,10,16,10,0,36,15,12,13,13,53,89
591,St. Lucia,Americas,c,2019,F,1,1,11,16,11,0,38,15,12,13,14,54,92
592,St. Vincent and the Grenadines,Americas,c,2019,F,1,1,11,15,10,0,36,15,12,14,14,55,91
593,Sudan,SSA,c,2019,NF,7,7,2,3,1,3,3,2,1,0,1,4,7
594,Suriname,Americas,c,2019,F,2,3,12,14,8,0,34,14,11,8,10,43,77
595,Swaziland,SSA,c,2019,NF,7,6,0,1,0,0,1,5,2,4,4,15,16
596,Sweden,Europe,c,2019,F,1,1,12,16,12,0,40,16,12,16,16,60,100
597,Switzerland,Europe,c,2019,F,1,1,12,15,12,0,39,15,12,15,15,57,96
598,Syria,MENA,c,2019,NF,7,7,0,0,0,3,-3,3,0,0,0,3,0
599,Taiwan,Asia,c,2019,F,1,1,12,15,10,0,37,16,11,15,14,56,93
600,Tajikistan,Eurasia,c,2019,NF,7,6,0,0,0,0,0,2,2,1,4,9,9
601,Tanzania,SSA,c,2019,PF,4,5,7,7,6,0,20,7,5,6,7,25,45
602,Thailand,Asia,c,2019,NF,7,5,0,3,2,0,5,6,4,5,10,25,30
603,The Gambia,SSA,c,2019,PF,4,5,7,9,4,0,20,8,6,5,6,25,45
604,Tibet,Asia,t,2019,NF,7,7,0,0,1,3,-2,0,0,0,3,3,1
605,Timor-Leste,Asia,c,2019,F,2,3,11,14,7,0,32,14,8,7,9,38,70
606,Togo,SSA,c,2019,PF,5,4,4,6,5,0,15,9,6,6,7,28,43
607,Tonga,Asia,c,2019,F,2,2,9,14,7,0,30,14,10,12,13,49,79
608,Transnistria,Eurasia,t,2019,NF,6,6,3,5,2,0,10,5,2,2,5,14,24
609,Trinidad and Tobago,Americas,c,2019,F,2,2,11,13,9,0,33,16,11,9,13,49,82
610,Tunisia,MENA,c,2019,F,2,3,11,14,6,0,31,12,7,9,10,38,69
611,Turkey,Europe,c,2019,NF,5,6,5,7,3,0,15,5,3,3,5,16,31
612,Turkmenistan,Eurasia,c,2019,NF,7,7,0,0,0,0,0,0,0,0,2,2,2
613,Tuvalu,Asia,c,2019,F,1,1,12,15,10,0,37,16,12,15,13,56,93
614,Uganda,SSA,c,2019,NF,6,5,3,5,3,0,11,10,4,4,7,25,36
615,Ukraine,Eurasia,c,2019,PF,3,4,9,11,6,0,26,11,7,6,10,34,60
616,United Arab Emirates,MENA,c,2019,NF,7,6,1,2,2,0,5,3,2,3,4,12,17
617,United Kingdom,Europe,c,2019,F,1,1,12,16,11,0,39,14,12,14,14,54,93
618,United States,Americas,c,2019,F,2,1,10,14,9,0,33,16,11,11,15,53,86
619,Uruguay,Americas,c,2019,F,1,1,12,16,12,0,40,16,12,15,15,58,98
620,Uzbekistan,Eurasia,c,2019,NF,7,6,0,0,1,0,1,2,1,1,4,8,9
621,Vanuatu,Asia,c,2019,F,2,2,10,15,8,0,33,15,11,12,11,49,82
622,Venezuela,Americas,c,2019,NF,7,6,0,3,0,0,3,7,2,1,6,16,19
623,Vietnam,Asia,c,2019,NF,7,5,0,1,2,0,3,4,1,4,8,17,20
624,West Bank,MENA,t,2019,NF,7,5,1,4,2,3,4,7,5,4,5,21,25
625,Western Sahara,MENA,t,2019,NF,7,7,0,0,0,3,-3,3,0,0,4,7,4
626,Yemen,MENA,c,2019,NF,7,6,0,1,0,0,1,3,3,2,2,10,11
627,Zambia,SSA,c,2019,PF,4,4,6,10,6,0,22,9,7,8,8,32,54
628,Zimbabwe,SSA,c,2019,PF,5,5,3,6,3,0,12,8,4,2,5,19,31
629,Abkhazia,Eurasia,t,2018,PF,4,5,6,8,4,0,18,8,6,4,5,23,41
630,Afghanistan,Asia,c,2018,NF,5,6,2,7,3,0,12,6,4,2,2,14,26
631,Albania,Europe,c,2018,PF,3,3,8,13,7,0,28,13,9,9,9,40,68
632,Algeria,MENA,c,2018,NF,6,5,3,4,3,0,10,7,5,6,7,25,35
633,Andorra,Europe,c,2018,F,1,1,12,15,12,0,39,15,11,15,16,57,96
634,Angola,SSA,c,2018,NF,6,6,3,6,1,0,10,7,3,3,3,16,26
635,Antigua and Barbuda,Americas,c,2018,F,2,2,12,13,8,0,33,15,9,13,13,50,83
636,Argentina,Americas,c,2018,F,2,2,11,14,8,0,33,15,11,10,14,50,83
637,Armenia,Eurasia,c,2018,PF,5,4,4,7,4,0,15,9,6,6,9,30,45
638,Australia,Asia,c,2018,F,1,1,12,16,12,0,40,16,12,15,15,58,98
639,Austria,Europe,c,2018,F,1,1,12,15,10,0,37,15,12,15,15,57,94
640,Azerbaijan,Eurasia,c,2018,NF,7,6,1,2,0,0,3,2,1,1,5,9,12
641,Bahamas,Americas,c,2018,F,1,1,12,16,10,0,38,15,12,13,13,53,91
642,Bahrain,MENA,c,2018,NF,7,6,2,0,3,3,2,2,1,1,6,10,12
643,Bangladesh,Asia,c,2018,PF,4,4,7,7,5,0,19,7,5,5,9,26,45
644,Barbados,Americas,c,2018,F,1,1,12,16,10,0,38,16,12,15,15,58,96
645,Belarus,Eurasia,c,2018,NF,6,6,0,4,2,0,6,3,3,2,7,15,21
646,Belgium,Europe,c,2018,F,1,1,12,16,11,0,39,15,12,14,15,56,95
647,Belize,Americas,c,2018,F,1,2,12,14,10,0,36,15,10,12,13,50,86
648,Benin,SSA,c,2018,F,2,2,9,16,8,0,33,15,12,12,10,49,82
649,Bhutan,Asia,c,2018,PF,3,4,10,10,9,1,28,9,4,6,8,27,55
650,Bolivia,Americas,c,2018,PF,3,3,10,11,7,0,28,14,9,6,10,39,67
651,Bosnia and Herzegovina,Europe,c,2018,PF,4,4,7,10,4,0,21,10,7,7,10,34,55
652,Botswana,SSA,c,2018,F,3,2,10,10,8,0,28,12,10,11,11,44,72
653,Brazil,Americas,c,2018,F,2,2,11,14,6,0,31,15,10,9,13,47,78
654,Brunei,Asia,c,2018,NF,6,5,0,3,3,0,6,6,3,6,7,22,28
655,Bulgaria,Europe,c,2018,F,2,2,11,14,8,0,33,14,11,10,12,47,80
656,Burkina Faso,SSA,c,2018,PF,4,3,7,10,6,0,23,13,9,7,8,37,60
657,Burundi,SSA,c,2018,NF,7,6,1,3,0,0,4,6,2,1,5,14,18
658,Cambodia,Asia,c,2018,NF,6,5,4,3,3,0,10,8,3,3,6,20,30
659,Cameroon,SSA,c,2018,NF,6,6,3,3,3,0,9,6,2,1,4,13,22
660,Canada,Americas,c,2018,F,1,1,12,16,12,0,40,16,12,15,16,59,99
661,Cape Verde,SSA,c,2018,F,1,1,12,15,10,0,37,15,11,14,13,53,90
662,Central African Republic,SSA,c,2018,NF,7,7,3,2,0,1,4,4,1,0,0,5,9
663,Chad,SSA,c,2018,NF,7,6,2,1,1,0,4,6,4,1,3,14,18
664,Chile,Americas,c,2018,F,1,1,12,15,10,0,37,16,12,14,15,57,94
665,China,Asia,c,2018,NF,7,6,0,0,2,2,0,3,3,2,6,14,14
666,Colombia,Americas,c,2018,PF,3,3,10,11,8,0,29,12,5,9,10,36,65
667,Comoros,SSA,c,2018,PF,3,4,9,11,4,0,24,10,7,8,6,31,55
668,Congo (Brazzaville),SSA,c,2018,NF,7,5,0,2,0,0,2,7,5,1,6,19,21
669,Congo (Kinshasa),SSA,c,2018,NF,7,6,0,3,1,0,4,7,2,0,4,13,17
670,Costa Rica,Americas,c,2018,F,1,1,12,15,11,0,38,16,11,13,13,53,91
671,Cote d'Ivoire,SSA,c,2018,PF,4,4,7,8,4,0,19,11,8,6,7,32,51
672,Crimea,Eurasia,t,2018,NF,7,6,0,0,0,1,-1,3,1,0,6,10,9
673,Croatia,Europe,c,2018,F,1,2,12,15,10,0,37,13,12,11,13,49,86
674,Cuba,Americas,c,2018,NF,7,6,0,0,1,0,1,5,0,2,6,13,14
675,Cyprus,Europe,c,2018,F,1,1,11,16,11,0,38,15,12,15,14,56,94
676,Czech Republic,Europe,c,2018,F,1,1,12,15,10,0,37,15,12,14,15,56,93
677,Denmark,Europe,c,2018,F,1,1,12,16,12,0,40,16,12,14,15,57,97
678,Djibouti,SSA,c,2018,NF,6,5,2,3,2,0,7,6,3,4,6,19,26
679,Dominica,Americas,c,2018,F,1,1,11,16,10,0,37,15,11,15,15,56,93
680,Dominican Republic,Americas,c,2018,PF,3,3,9,10,7,0,26,14,10,8,9,41,67
681,Ecuador,Americas,c,2018,PF,3,3,7,11,7,0,25,12,7,6,10,35,60
682,Egypt,MENA,c,2018,NF,6,6,3,4,3,0,10,5,2,3,6,16,26
683,El Salvador,Americas,c,2018,F,2,3,11,14,9,0,34,12,8,8,8,36,70
684,Equatorial Guinea,SSA,c,2018,NF,7,7,0,1,0,0,1,3,0,0,3,6,7
685,Eritrea,SSA,c,2018,NF,7,7,0,0,1,0,1,0,0,0,2,2,3
686,Estonia,Europe,c,2018,F,1,1,12,15,11,0,38,16,12,14,14,56,94
687,Ethiopia,SSA,c,2018,NF,7,6,1,0,3,0,4,2,0,2,4,8,12
688,Fiji,Asia,c,2018,PF,3,3,8,9,7,0,24,12,6,7,10,35,59
689,Finland,Europe,c,2018,F,1,1,12,16,12,0,40,16,12,16,16,60,100
690,France,Europe,c,2018,F,1,2,12,15,11,0,38,14,11,13,14,52,90
691,Gabon,SSA,c,2018,NF,7,5,0,2,2,0,4,8,3,3,5,19,23
692,Gaza Strip,MENA,t,2018,NF,7,6,0,2,1,0,3,4,3,0,2,9,12
693,Georgia,Eurasia,c,2018,PF,3,3,9,10,7,0,26,11,8,8,11,38,64
694,Germany,Europe,c,2018,F,1,1,12,15,12,0,39,14,12,14,15,55,94
695,Ghana,SSA,c,2018,F,1,2,12,15,10,0,37,14,11,11,10,46,83
696,Greece,Europe,c,2018,F,2,2,12,15,8,0,35,14,12,11,13,50,85
697,Grenada,Americas,c,2018,F,1,2,11,16,10,0,37,15,11,12,13,51,88
698,Guatemala,Americas,c,2018,PF,4,4,8,10,5,0,23,12,6,7,8,33,56
699,Guinea,SSA,c,2018,PF,5,5,6,8,3,0,17,10,5,4,5,24,41
700,Guinea-Bissau,SSA,c,2018,PF,5,5,7,8,1,0,16,10,6,4,5,25,41
701,Guyana,Americas,c,2018,F,2,3,11,13,8,0,32,15,10,8,9,42,74
702,Haiti,Americas,c,2018,PF,5,5,5,7,5,0,17,10,4,4,6,24,41
703,Honduras,Americas,c,2018,PF,4,4,7,8,5,0,20,9,4,5,8,26,46
704,Hong Kong,Asia,t,2018,PF,5,2,2,7,6,0,15,12,8,11,13,44,59
705,Hungary,Europe,c,2018,F,3,2,9,12,7,0,28,11,10,10,13,44,72
706,Iceland,Europe,c,2018,F,1,1,12,15,10,0,37,15,12,15,16,58,95
707,India,Asia,c,2018,F,2,3,12,14,9,0,35,13,10,9,10,42,77
708,Indian Kashmir,Asia,t,2018,PF,4,4,9,9,4,0,22,9,5,5,8,27,49
709,Indonesia,Asia,c,2018,PF,2,4,11,13,6,0,30,12,8,5,9,34,64
710,Iran,MENA,c,2018,NF,6,6,3,2,2,0,7,3,1,3,4,11,18
711,Iraq,MENA,c,2018,NF,5,6,8,7,2,1,16,5,6,0,4,15,31
712,Ireland,Europe,c,2018,F,1,1,12,16,11,0,39,16,12,14,15,57,96
713,Israel,MENA,c,2018,F,1,3,12,14,10,0,36,12,9,11,11,43,79
714,Italy,Europe,c,2018,F,1,1,12,14,10,0,36,15,12,12,14,53,89
715,Jamaica,Americas,c,2018,F,2,3,12,13,9,0,34,15,9,8,11,43,77
716,Japan,Asia,c,2018,F,1,1,12,16,12,0,40,15,12,15,14,56,96
717,Jordan,MENA,c,2018,PF,5,5,3,6,3,0,12,7,3,7,8,25,37
718,Kazakhstan,Eurasia,c,2018,NF,7,5,1,3,1,0,5,4,1,4,8,17,22
719,Kenya,SSA,c,2018,PF,4,4,6,8,5,0,19,10,7,5,7,29,48
720,Kiribati,Asia,c,2018,F,1,1,12,16,10,0,38,15,12,15,13,55,93
721,Kosovo,Europe,c,2018,PF,3,4,9,10,5,0,24,9,6,6,7,28,52
722,Kuwait,MENA,c,2018,PF,5,5,2,7,4,0,13,6,4,7,6,23,36
723,Kyrgyzstan,Eurasia,c,2018,PF,5,5,4,5,4,1,12,10,4,4,7,25,37
724,Laos,Asia,c,2018,NF,7,6,0,0,1,0,1,4,0,2,5,11,12
725,Latvia,Europe,c,2018,F,2,2,12,14,9,0,35,15,12,12,13,52,87
726,Lebanon,MENA,c,2018,PF,6,4,3,7,1,0,11,12,8,5,7,32,43
727,Lesotho,SSA,c,2018,PF,3,3,10,11,6,0,27,12,7,9,9,37,64
728,Liberia,SSA,c,2018,PF,3,3,8,12,7,0,27,11,8,7,9,35,62
729,Libya,MENA,c,2018,NF,7,6,0,1,0,0,1,4,2,0,2,8,9
730,Liechtenstein,Europe,c,2018,F,2,1,10,13,10,0,33,16,12,14,15,57,90
731,Lithuania,Europe,c,2018,F,1,1,12,16,10,0,38,16,11,12,14,53,91
732,Luxembourg,Europe,c,2018,F,1,1,12,16,10,0,38,16,12,16,16,60,98
733,Macedonia,Europe,c,2018,PF,4,3,6,9,6,0,21,11,8,8,10,37,58
734,Madagascar,SSA,c,2018,PF,3,4,9,10,5,0,24,10,8,6,8,32,56
735,Malawi,SSA,c,2018,PF,3,3,8,12,6,0,26,13,8,9,7,37,63
736,Malaysia,Asia,c,2018,PF,4,4,6,7,5,0,18,7,6,5,9,27,45
737,Maldives,Asia,c,2018,PF,5,5,5,5,4,0,14,3,5,6,7,21,35
738,Mali,SSA,c,2018,PF,5,4,6,7,4,0,17,11,6,6,4,27,44
739,Malta,Europe,c,2018,F,1,1,12,14,10,0,36,15,12,15,14,56,92
740,Marshall Islands,Asia,c,2018,F,1,1,12,15,10,0,37,16,11,15,13,55,92
741,Mauritania,SSA,c,2018,NF,6,5,3,2,4,0,9,9,4,4,4,21,30
742,Mauritius,SSA,c,2018,F,1,2,12,15,10,0,37,15,12,13,12,52,89
743,Mexico,Americas,c,2018,PF,3,3,9,12,5,0,26,13,7,6,10,36,62
744,Micronesia,Asia,c,2018,F,1,1,12,15,10,0,37,16,11,15,14,56,93
745,Moldova,Eurasia,c,2018,PF,3,3,10,11,5,0,26,12,8,6,9,35,61
746,Monaco,Europe,c,2018,F,3,1,7,10,8,0,25,16,12,15,14,57,82
747,Mongolia,Asia,c,2018,F,1,2,11,16,9,0,36,14,11,12,12,49,85
748,Montenegro,Europe,c,2018,PF,3,3,8,10,7,0,25,11,9,10,12,42,67
749,Morocco,MENA,c,2018,PF,5,5,5,6,3,0,14,7,5,6,7,25,39
750,Mozambique,SSA,c,2018,PF,4,4,6,9,5,0,20,9,7,7,9,32,52
751,Myanmar,Asia,c,2018,PF,5,5,5,8,4,4,13,6,6,1,5,18,31
752,Nagorno-Karabakh,Eurasia,t,2018,PF,5,5,4,5,3,0,12,6,3,4,5,18,30
753,Namibia,SSA,c,2018,F,2,2,10,11,9,0,30,14,12,11,10,47,77
754,Nauru,Asia,c,2018,F,2,2,12,15,8,0,35,13,9,10,14,46,81
755,Nepal,Asia,c,2018,PF,3,4,10,10,5,0,25,10,6,6,8,30,55
756,Netherlands,Europe,c,2018,F,1,1,12,16,12,0,40,16,12,15,16,59,99
757,New Zealand,Asia,c,2018,F,1,1,12,16,12,0,40,16,12,15,15,58,98
758,Nicaragua,Americas,c,2018,PF,5,4,3,6,3,0,12,11,5,6,10,32,44
759,Niger,SSA,c,2018,PF,4,4,6,8,6,0,20,11,6,6,6,29,49
760,Nigeria,SSA,c,2018,PF,3,5,9,10,6,0,25,9,7,4,5,25,50
761,North Korea,Asia,c,2018,NF,7,7,0,0,0,0,0,0,0,0,3,3,3
762,Northern Cyprus,Europe,t,2018,F,2,2,11,13,7,0,31,15,11,13,11,50,81
763,Norway,Europe,c,2018,F,1,1,12,16,12,0,40,16,12,16,16,60,100
764,Oman,MENA,c,2018,NF,6,5,2,2,2,0,6,5,3,4,5,17,23
765,Pakistan,Asia,c,2018,PF,4,5,6,8,5,0,19,7,6,5,6,24,43
766,Pakistani Kashmir,Asia,t,2018,NF,6,5,4,4,3,2,9,6,4,3,6,19,28
767,Palau,Asia,c,2018,F,1,1,12,15,10,0,37,16,11,15,13,55,92
768,Panama,Americas,c,2018,F,2,2,12,15,8,0,35,15,11,10,12,48,83
769,Papua New Guinea,Asia,c,2018,PF,3,3,8,13,4,0,25,13,9,7,9,38,63
770,Paraguay,Americas,c,2018,PF,3,3,10,12,5,0,27,12,8,7,10,37,64
771,Peru,Americas,c,2018,F,2,3,11,13,7,0,31,15,8,8,11,42,73
772,Philippines,Asia,c,2018,PF,3,3,9,11,7,0,27,14,8,3,10,35,62
773,Poland,Europe,c,2018,F,1,2,12,16,8,0,36,14,10,11,14,49,85
774,Portugal,Europe,c,2018,F,1,1,12,16,11,0,39,16,12,15,15,58,97
775,Qatar,MENA,c,2018,NF,6,5,2,2,3,0,7,7,2,4,4,17,24
776,Romania,Europe,c,2018,F,2,2,11,14,10,0,35,14,11,12,12,49,84
777,Russia,Eurasia,c,2018,NF,7,6,0,3,2,0,5,3,3,2,7,15,20
778,Rwanda,SSA,c,2018,NF,6,6,2,1,5,0,8,4,2,2,7,15,23
779,Samoa,Asia,c,2018,F,2,2,9,12,9,0,30,14,10,14,12,50,80
780,San Marino,Europe,c,2018,F,1,1,12,15,11,0,38,15,12,16,16,59,97
781,Sao Tome and Principe,SSA,c,2018,F,2,2,11,14,9,0,34,15,10,12,11,48,82
782,Saudi Arabia,MENA,c,2018,NF,7,7,0,0,1,1,0,3,0,2,2,7,7
783,Senegal,SSA,c,2018,F,2,2,10,13,8,0,31,13,10,10,11,44,75
784,Serbia,Europe,c,2018,F,3,2,9,12,7,0,28,13,10,9,13,45,73
785,Seychelles,SSA,c,2018,PF,3,3,10,11,7,0,28,12,9,11,11,43,71
786,Sierra Leone,SSA,c,2018,PF,3,3,10,11,7,0,28,12,7,9,10,38,66
787,Singapore,Asia,c,2018,PF,4,4,4,8,7,0,19,10,4,7,12,33,52
788,Slovakia,Europe,c,2018,F,1,1,12,15,9,0,36,15,12,12,14,53,89
789,Slovenia,Europe,c,2018,F,1,1,12,16,11,0,39,14,12,14,14,54,93
790,Solomon Islands,Asia,c,2018,F,3,2,9,13,6,0,28,14,9,9,12,44,72
791,Somalia,SSA,c,2018,NF,7,7,0,1,0,0,1,3,2,0,1,6,7
792,Somaliland,SSA,t,2018,PF,4,5,5,10,4,0,19,7,5,7,6,25,44
793,South Africa,SSA,c,2018,F,2,2,12,13,7,0,32,15,12,9,10,46,78
794,South Korea,Asia,c,2018,F,2,2,11,13,9,0,33,14,11,13,13,51,84
795,South Ossetia,Eurasia,t,2018,NF,7,6,2,2,0,2,2,3,1,1,3,8,10
796,South Sudan,SSA,c,2018,NF,7,7,1,1,0,4,-2,2,2,0,0,4,2
797,Spain,Europe,c,2018,F,1,1,11,16,11,0,38,15,11,15,15,56,94
798,Sri Lanka,Asia,c,2018,PF,3,4,8,10,7,1,24,8,8,7,8,31,55
799,St. Kitts and Nevis,Americas,c,2018,F,1,1,10,16,10,0,36,15,12,13,13,53,89
800,St. Lucia,Americas,c,2018,F,1,1,11,16,11,0,38,15,12,12,14,53,91
801,St. Vincent and the Grenadines,Americas,c,2018,F,1,1,11,15,10,0,36,15,12,13,14,54,90
802,Sudan,SSA,c,2018,NF,7,7,2,4,1,3,4,2,1,0,1,4,8
803,Suriname,Americas,c,2018,F,2,2,12,14,8,0,34,15,11,8,10,44,78
804,Swaziland,SSA,c,2018,NF,7,6,0,1,0,0,1,5,2,4,4,15,16
805,Sweden,Europe,c,2018,F,1,1,12,16,12,0,40,16,12,16,16,60,100
806,Switzerland,Europe,c,2018,F,1,1,12,15,12,0,39,15,12,15,15,57,96
807,Syria,MENA,c,2018,NF,7,7,0,0,0,3,-3,2,0,0,0,2,-1
808,Taiwan,Asia,c,2018,F,1,1,12,15,10,0,37,16,11,15,14,56,93
809,Tajikistan,Eurasia,c,2018,NF,7,6,0,0,1,0,1,2,2,2,4,10,11
810,Tanzania,SSA,c,2018,PF,4,4,7,9,6,0,22,7,6,8,9,30,52
811,Thailand,Asia,c,2018,NF,6,5,0,3,3,0,6,6,4,5,10,25,31
812,The Gambia,SSA,c,2018,PF,4,5,7,9,4,0,20,7,5,3,6,21,41
813,Tibet,Asia,t,2018,NF,7,7,0,0,1,3,-2,0,0,0,3,3,1
814,Timor-Leste,Asia,c,2018,F,2,3,11,14,7,0,32,13,8,7,9,37,69
815,Togo,SSA,c,2018,PF,4,4,6,7,5,0,18,9,6,7,7,29,47
816,Tonga,Asia,c,2018,F,2,2,9,14,7,0,30,12,9,12,12,45,75
817,Transnistria,Eurasia,t,2018,NF,6,6,3,5,2,0,10,5,2,2,5,14,24
818,Trinidad and Tobago,Americas,c,2018,F,2,2,11,13,9,0,33,15,11,9,13,48,81
819,Tunisia,MENA,c,2018,F,2,3,10,14,6,0,30,12,9,9,10,40,70
820,Turkey,Europe,c,2018,NF,5,6,6,7,3,0,16,5,3,2,6,16,32
821,Turkmenistan,Eurasia,c,2018,NF,7,7,0,0,0,0,0,1,0,0,3,4,4
822,Tuvalu,Asia,c,2018,F,1,1,12,15,10,0,37,16,12,15,14,57,94
823,Uganda,SSA,c,2018,PF,6,4,3,5,3,0,11,11,4,4,7,26,37
824,Ukraine,Eurasia,c,2018,PF,3,3,9,11,6,0,26,11,9,6,10,36,62
825,United Arab Emirates,MENA,c,2018,NF,7,6,1,2,2,0,5,3,2,3,4,12,17
826,United Kingdom,Europe,c,2018,F,1,1,12,16,12,0,40,14,12,14,14,54,94
827,United States,Americas,c,2018,F,2,1,10,14,9,0,33,16,10,12,15,53,86
828,Uruguay,Americas,c,2018,F,1,1,12,16,12,0,40,16,12,15,15,58,98
829,Uzbekistan,Eurasia,c,2018,NF,7,7,0,0,1,0,1,1,1,0,4,6,7
830,Vanuatu,Asia,c,2018,F,2,2,10,15,8,0,33,15,11,11,11,48,81
831,Venezuela,Americas,c,2018,NF,6,5,2,6,0,0,8,8,2,1,7,18,26
832,Vietnam,Asia,c,2018,NF,7,5,0,1,2,0,3,4,1,4,8,17,20
833,West Bank,MENA,t,2018,NF,7,5,2,4,2,3,5,8,5,5,5,23,28
834,Western Sahara,MENA,t,2018,NF,7,7,0,0,0,3,-3,3,0,0,4,7,4
835,Yemen,MENA,c,2018,NF,7,6,0,1,0,0,1,5,3,2,2,12,13
836,Zambia,SSA,c,2018,PF,4,4,6,10,6,0,22,10,7,8,8,33,55
837,Zimbabwe,SSA,c,2018,NF,6,5,2,6,2,0,10,8,4,3,5,20,30
838,Abkhazia,Eurasia,t,2017,PF,4,5,6,8,4,0,18,8,6,4,5,23,41
839,Afghanistan,Asia,c,2017,NF,6,6,2,6,2,0,10,6,4,2,2,14,24
840,Albania,Europe,c,2017,PF,3,3,8,13,7,0,28,13,9,9,9,40,68
841,Algeria,MENA,c,2017,NF,6,5,4,4,3,0,11,7,5,5,7,24,35
842,Andorra,Europe,c,2017,F,1,1,12,15,12,0,39,15,11,15,15,56,95
843,Angola,SSA,c,2017,NF,6,6,3,6,1,0,10,5,3,3,3,14,24
844,Antigua and Barbuda,Americas,c,2017,F,2,2,12,13,8,0,33,15,9,13,13,50,83
845,Argentina,Americas,c,2017,F,2,2,11,14,8,0,33,14,11,10,14,49,82
846,Armenia,Eurasia,c,2017,PF,5,4,5,7,4,0,16,9,6,5,9,29,45
847,Australia,Asia,c,2017,F,1,1,12,16,12,0,40,16,12,15,15,58,98
848,Austria,Europe,c,2017,F,1,1,12,15,10,0,37,16,12,15,15,58,95
849,Azerbaijan,Eurasia,c,2017,NF,7,6,1,2,1,0,4,2,1,2,5,10,14
850,Bahamas,Americas,c,2017,F,1,1,12,16,10,0,38,15,12,13,13,53,91
851,Bahrain,MENA,c,2017,NF,7,6,2,0,3,3,2,2,1,1,6,10,12
852,Bangladesh,Asia,c,2017,PF,4,4,7,8,5,0,20,7,6,5,9,27,47
853,Barbados,Americas,c,2017,F,1,1,12,16,12,0,40,16,12,15,15,58,98
854,Belarus,Eurasia,c,2017,NF,7,6,0,4,1,0,5,3,3,2,7,15,20
855,Belgium,Europe,c,2017,F,1,1,12,16,12,0,40,15,12,13,15,55,95
856,Belize,Americas,c,2017,F,1,2,12,14,10,0,36,15,11,12,13,51,87
857,Benin,SSA,c,2017,F,2,2,9,16,8,0,33,15,12,12,10,49,82
858,Bhutan,Asia,c,2017,PF,3,4,10,10,9,1,28,9,4,6,8,27,55
859,Bolivia,Americas,c,2017,PF,3,3,11,11,7,0,29,14,9,6,10,39,68
860,Bosnia and Herzegovina,Europe,c,2017,PF,4,4,7,10,4,0,21,10,7,7,10,34,55
861,Botswana,SSA,c,2017,F,3,2,10,10,8,0,28,12,10,11,11,44,72
862,Brazil,Americas,c,2017,F,2,2,11,14,6,0,31,15,10,10,13,48,79
863,Brunei,Asia,c,2017,NF,6,5,0,3,3,0,7,6,3,6,7,22,29
864,Bulgaria,Europe,c,2017,F,2,2,11,14,8,0,33,14,11,10,12,47,80
865,Burkina Faso,SSA,c,2017,PF,4,3,7,10,6,0,23,14,9,8,9,40,63
866,Burundi,SSA,c,2017,NF,7,6,1,4,0,0,5,6,2,1,5,14,19
867,Cambodia,Asia,c,2017,NF,6,5,4,4,3,0,11,8,3,3,6,20,31
868,Cameroon,SSA,c,2017,NF,6,6,3,3,3,0,9,7,3,1,4,15,24
869,Canada,Americas,c,2017,F,1,1,12,16,12,0,40,16,12,15,16,59,99
870,Cape Verde,SSA,c,2017,F,1,1,12,15,10,0,37,15,11,14,13,53,90
871,Central African Republic,SSA,c,2017,NF,7,7,3,2,0,1,4,4,1,0,1,6,10
872,Chad,SSA,c,2017,NF,7,6,2,1,1,0,4,6,4,1,3,14,18
873,Chile,Americas,c,2017,F,1,1,12,15,10,0,37,16,12,14,15,57,94
874,China,Asia,c,2017,NF,7,6,0,1,2,2,1,3,3,2,6,14,15
875,Colombia,Americas,c,2017,PF,3,3,10,11,8,0,29,12,5,8,10,35,64
876,Comoros,SSA,c,2017,PF,3,4,9,11,4,0,24,10,7,8,6,31,55
877,Congo (Brazzaville),SSA,c,2017,NF,7,5,1,2,2,0,5,7,6,2,7,22,27
878,Congo (Kinshasa),SSA,c,2017,NF,7,6,0,3,1,0,4,8,3,0,4,15,19
879,Costa Rica,Americas,c,2017,F,1,1,12,15,11,0,38,16,11,13,13,53,91
880,Cote d'Ivoire,SSA,c,2017,PF,4,4,7,8,5,0,20,11,8,6,7,32,52
881,Crimea,Eurasia,t,2017,NF,7,6,0,0,0,1,-1,3,1,0,6,10,9
882,Croatia,Europe,c,2017,F,1,2,12,15,10,0,37,14,12,11,13,50,87
883,Cuba,Americas,c,2017,NF,7,6,0,0,1,0,1,5,0,3,6,14,15
884,Cyprus,Europe,c,2017,F,1,1,11,16,11,0,38,15,12,15,14,56,94
885,Czech Republic,Europe,c,2017,F,1,1,12,15,11,0,38,15,12,14,15,56,94
886,Denmark,Europe,c,2017,F,1,1,12,16,12,0,40,16,12,14,15,57,97
887,Djibouti,SSA,c,2017,NF,6,5,2,3,2,0,7,6,3,4,6,19,26
888,Dominica,Americas,c,2017,F,1,1,12,16,10,0,38,15,12,15,15,57,95
889,Dominican Republic,Americas,c,2017,PF,3,3,9,10,8,0,27,14,10,8,9,41,68
890,Ecuador,Americas,c,2017,PF,3,4,7,11,6,0,24,11,6,6,10,33,57
891,Egypt,MENA,c,2017,NF,6,5,3,4,2,0,9,5,4,2,6,17,26
892,El Salvador,Americas,c,2017,F,2,3,11,14,9,0,34,12,8,8,8,36,70
893,Equatorial Guinea,SSA,c,2017,NF,7,7,0,1,0,0,1,4,0,0,3,7,8
894,Eritrea,SSA,c,2017,NF,7,7,0,0,1,0,1,0,0,0,2,2,3
895,Estonia,Europe,c,2017,F,1,1,12,15,11,0,38,16,12,14,14,56,94
896,Ethiopia,SSA,c,2017,NF,7,6,1,0,3,0,4,2,0,2,4,8,12
897,Fiji,Asia,c,2017,PF,3,4,8,10,7,0,25,12,5,7,10,34,59
898,Finland,Europe,c,2017,F,1,1,12,16,12,0,40,16,12,16,16,60,100
899,France,Europe,c,2017,F,1,2,12,15,11,0,38,14,11,13,14,52,90
900,Gabon,SSA,c,2017,NF,6,5,2,3,3,0,8,9,4,6,5,24,32
901,Gaza Strip,MENA,t,2017,NF,7,6,0,2,1,0,3,4,3,0,2,9,12
902,Georgia,Eurasia,c,2017,PF,3,3,9,11,7,0,27,11,8,8,10,37,64
903,Germany,Europe,c,2017,F,1,1,12,15,12,0,39,15,12,14,15,56,95
904,Ghana,SSA,c,2017,F,1,2,12,15,10,0,37,14,11,11,10,46,83
905,Greece,Europe,c,2017,F,2,2,12,15,8,0,35,14,11,11,13,49,84
906,Grenada,Americas,c,2017,F,1,2,12,16,10,0,38,15,11,12,13,51,89
907,Guatemala,Americas,c,2017,PF,4,4,8,10,5,0,23,11,6,6,8,31,54
908,Guinea,SSA,c,2017,PF,5,5,6,8,3,0,17,10,5,4,5,24,41
909,Guinea-Bissau,SSA,c,2017,PF,5,5,7,8,1,0,16,10,5,4,5,24,40
910,Guyana,Americas,c,2017,F,2,3,11,13,8,0,32,15,10,8,9,42,74
911,Haiti,Americas,c,2017,PF,5,5,3,8,4,0,15,10,4,4,6,24,39
912,Honduras,Americas,c,2017,PF,4,4,7,8,4,0,19,9,5,5,8,27,46
913,Hong Kong,Asia,t,2017,PF,5,2,3,7,6,0,16,12,8,12,13,45,61
914,Hungary,Europe,c,2017,F,3,2,9,13,7,0,29,13,11,10,13,47,76
915,Iceland,Europe,c,2017,F,1,1,12,16,10,0,38,16,12,15,16,59,97
916,India,Asia,c,2017,F,2,3,12,14,9,0,35,13,10,9,10,42,77
917,Indian Kashmir,Asia,t,2017,PF,4,4,9,9,4,0,22,9,5,6,8,28,50
918,Indonesia,Asia,c,2017,PF,2,4,11,14,6,0,31,12,8,5,9,34,65
919,Iran,MENA,c,2017,NF,6,6,3,2,2,0,7,2,1,3,4,10,17
920,Iraq,MENA,c,2017,NF,5,6,8,5,2,3,12,5,6,0,4,15,27
921,Ireland,Europe,c,2017,F,1,1,12,16,11,0,39,16,12,14,15,57,96
922,Israel,MENA,c,2017,F,1,2,12,14,10,0,36,12,10,11,11,44,80
923,Italy,Europe,c,2017,F,1,1,12,14,10,0,36,15,12,12,14,53,89
924,Jamaica,Americas,c,2017,F,2,3,12,13,9,0,34,15,9,7,10,41,75
925,Japan,Asia,c,2017,F,1,1,12,16,12,0,40,15,12,15,14,56,96
926,Jordan,MENA,c,2017,PF,5,5,3,6,3,0,12,7,4,6,8,25,37
927,Kazakhstan,Eurasia,c,2017,NF,7,5,1,3,1,0,5,4,1,4,8,17,22
928,Kenya,SSA,c,2017,PF,4,4,7,10,5,0,22,10,7,5,7,29,51
929,Kiribati,Asia,c,2017,F,1,1,12,16,9,0,37,15,12,15,13,55,92
930,Kosovo,Europe,c,2017,PF,3,4,9,10,5,0,24,9,6,6,7,28,52
931,Kuwait,MENA,c,2017,PF,5,5,2,7,4,0,13,6,4,7,6,23,36
932,Kyrgyzstan,Eurasia,c,2017,PF,5,5,5,6,4,2,13,9,4,4,7,24,37
933,Laos,Asia,c,2017,NF,7,6,0,0,1,0,1,4,0,2,5,11,12
934,Latvia,Europe,c,2017,F,1,2,12,15,9,0,36,15,12,12,12,51,87
935,Lebanon,MENA,c,2017,PF,5,4,3,9,2,0,14,11,7,5,7,30,44
936,Lesotho,SSA,c,2017,PF,3,3,10,11,6,0,27,12,7,9,9,37,64
937,Liberia,SSA,c,2017,PF,3,4,9,12,7,0,28,11,8,7,8,34,62
938,Libya,MENA,c,2017,NF,7,6,1,2,0,0,3,4,2,0,4,10,13
939,Liechtenstein,Europe,c,2017,F,2,1,10,13,10,0,33,16,12,14,16,58,91
940,Lithuania,Europe,c,2017,F,1,1,12,16,10,0,38,16,11,13,13,53,91
941,Luxembourg,Europe,c,2017,F,1,1,12,16,10,0,38,16,12,16,16,60,98
942,Macedonia,Europe,c,2017,PF,4,3,6,10,5,0,21,10,8,8,10,36,57
943,Madagascar,SSA,c,2017,PF,3,4,9,10,5,0,24,10,8,6,8,32,56
944,Malawi,SSA,c,2017,PF,3,3,8,12,6,0,26,13,8,9,7,37,63
945,Malaysia,Asia,c,2017,PF,4,4,6,7,5,0,18,7,5,5,9,26,44
946,Maldives,Asia,c,2017,PF,5,5,7,5,5,0,17,5,5,6,7,23,40
947,Mali,SSA,c,2017,PF,5,4,6,7,4,0,17,12,6,6,4,28,45
948,Malta,Europe,c,2017,F,1,1,12,16,11,0,39,16,12,15,14,57,96
949,Marshall Islands,Asia,c,2017,F,1,1,12,15,10,0,37,16,11,15,13,55,92
950,Mauritania,SSA,c,2017,NF,6,5,3,2,4,0,9,9,4,4,4,21,30
951,Mauritius,SSA,c,2017,F,1,2,12,15,10,0,37,15,12,13,12,52,89
952,Mexico,Americas,c,2017,PF,3,3,9,12,7,0,28,13,8,6,10,37,65
953,Micronesia,Asia,c,2017,F,1,1,12,15,10,0,37,16,11,15,14,56,93
954,Moldova,Eurasia,c,2017,PF,3,3,10,12,5,0,27,12,8,6,9,35,62
955,Monaco,Europe,c,2017,F,3,1,7,11,9,0,27,16,12,15,14,57,84
956,Mongolia,Asia,c,2017,F,1,2,11,16,9,0,36,14,11,12,12,49,85
957,Montenegro,Europe,c,2017,PF,3,3,8,11,7,0,26,12,9,10,12,43,69
958,Morocco,MENA,c,2017,PF,5,4,5,7,3,0,15,7,6,6,7,26,41
959,Mozambique,SSA,c,2017,PF,4,4,6,9,5,0,20,11,7,7,8,33,53
960,Myanmar,Asia,c,2017,PF,5,5,5,8,4,3,14,7,5,1,5,18,32
961,Nagorno-Karabakh,Eurasia,t,2017,PF,5,5,6,6,3,0,15,6,3,4,5,18,33
962,Namibia,SSA,c,2017,F,2,2,10,11,9,0,30,14,12,11,10,47,77
963,Nauru,Asia,c,2017,F,2,2,12,15,8,0,35,13,9,10,14,46,81
964,Nepal,Asia,c,2017,PF,3,4,9,10,5,0,24,9,5,6,8,28,52
965,Netherlands,Europe,c,2017,F,1,1,12,16,12,0,40,16,12,15,16,59,99
966,New Zealand,Asia,c,2017,F,1,1,12,16,12,0,40,16,12,15,15,58,98
967,Nicaragua,Americas,c,2017,PF,5,4,3,6,5,0,14,11,5,7,10,33,47
968,Niger,SSA,c,2017,PF,4,4,6,9,6,0,21,11,6,5,6,28,49
969,Nigeria,SSA,c,2017,PF,3,5,9,10,6,0,25,9,7,4,5,25,50
970,North Korea,Asia,c,2017,NF,7,7,0,0,0,0,0,0,0,0,3,3,3
971,Northern Cyprus,Europe,t,2017,F,2,2,11,12,9,0,32,14,11,12,11,48,80
972,Norway,Europe,c,2017,F,1,1,12,16,12,0,40,16,12,16,16,60,100
973,Oman,MENA,c,2017,NF,6,5,2,2,2,0,8,5,3,4,5,17,25
974,Pakistan,Asia,c,2017,PF,4,5,7,8,6,0,21,6,6,4,6,22,43
975,Pakistani Kashmir,Asia,t,2017,NF,6,5,4,4,3,2,9,6,4,3,6,19,28
976,Palau,Asia,c,2017,F,1,1,12,15,10,0,37,16,11,15,13,55,92
977,Panama,Americas,c,2017,F,2,2,12,15,8,0,35,15,11,10,12,48,83
978,Papua New Guinea,Asia,c,2017,PF,3,3,9,13,4,0,26,13,9,7,9,38,64
979,Paraguay,Americas,c,2017,PF,3,3,10,12,5,0,27,12,8,7,10,37,64
980,Peru,Americas,c,2017,F,2,3,11,13,7,0,31,15,8,8,10,41,72
981,Philippines,Asia,c,2017,PF,3,3,9,11,7,0,27,14,8,4,10,36,63
982,Poland,Europe,c,2017,F,1,2,12,16,9,0,37,14,12,12,14,52,89
983,Portugal,Europe,c,2017,F,1,1,12,16,11,0,39,16,12,15,15,58,97
984,Qatar,MENA,c,2017,NF,6,5,2,2,3,0,9,7,2,4,4,17,26
985,Romania,Europe,c,2017,F,2,2,11,14,10,0,35,14,11,12,12,49,84
986,Russia,Eurasia,c,2017,NF,7,6,0,3,2,0,5,3,3,2,7,15,20
987,Rwanda,SSA,c,2017,NF,6,6,2,1,5,0,8,4,2,3,7,16,24
988,Samoa,Asia,c,2017,F,2,2,9,12,9,0,30,14,10,14,12,50,80
989,San Marino,Europe,c,2017,F,1,1,12,15,11,0,38,15,12,16,16,59,97
990,Sao Tome and Principe,SSA,c,2017,F,2,2,11,14,9,0,34,15,10,12,10,47,81
991,Saudi Arabia,MENA,c,2017,NF,7,7,0,0,1,0,3,3,0,2,2,7,10
992,Senegal,SSA,c,2017,F,2,2,11,13,8,0,32,15,10,10,11,46,78
993,Serbia,Europe,c,2017,F,3,2,9,13,7,0,29,14,10,10,13,47,76
994,Seychelles,SSA,c,2017,PF,3,3,10,11,7,0,28,12,9,11,11,43,71
995,Sierra Leone,SSA,c,2017,PF,3,3,10,11,7,0,28,12,7,9,10,38,66
996,Singapore,Asia,c,2017,PF,4,4,4,8,7,0,19,9,4,7,12,32,51
997,Slovakia,Europe,c,2017,F,1,1,12,15,9,0,36,15,12,12,14,53,89
998,Slovenia,Europe,c,2017,F,1,1,12,16,11,0,39,14,12,14,13,53,92
999,Solomon Islands,Asia,c,2017,F,3,2,9,13,5,0,27,14,9,9,12,44,71
1000,Somalia,SSA,c,2017,NF,7,7,0,0,0,0,0,3,1,0,1,5,5
1001,Somaliland,SSA,t,2017,PF,5,5,2,9,4,0,15,7,5,7,6,25,40
1002,South Africa,SSA,c,2017,F,2,2,12,14,7,0,33,15,11,9,10,45,78
1003,South Korea,Asia,c,2017,F,2,2,11,13,8,0,32,13,11,13,13,50,82
1004,South Ossetia,Eurasia,t,2017,NF,7,6,2,2,0,2,2,4,1,1,3,9,11
1005,South Sudan,SSA,c,2017,NF,7,7,1,1,0,4,-2,4,2,0,0,6,4
1006,Spain,Europe,c,2017,F,1,1,12,16,10,0,38,15,11,15,15,56,94
1007,Sri Lanka,Asia,c,2017,PF,3,4,8,10,7,1,24,9,8,7,8,32,56
1008,St. Kitts and Nevis,Americas,c,2017,F,1,1,10,16,10,0,36,15,12,13,13,53,89
1009,St. Lucia,Americas,c,2017,F,1,1,12,16,11,0,39,15,12,12,14,53,92
1010,St. Vincent and the Grenadines,Americas,c,2017,F,1,1,11,16,10,0,37,15,12,13,14,54,91
1011,Sudan,SSA,c,2017,NF,7,7,2,3,1,4,2,2,1,0,1,4,6
1012,Suriname,Americas,c,2017,F,2,3,12,14,8,0,34,15,11,7,10,43,77
1013,Swaziland,SSA,c,2017,NF,7,5,0,1,0,0,1,7,2,4,4,17,18
1014,Sweden,Europe,c,2017,F,1,1,12,16,12,0,40,16,12,16,16,60,100
1015,Switzerland,Europe,c,2017,F,1,1,12,15,12,0,39,15,12,15,15,57,96
1016,Syria,MENA,c,2017,NF,7,7,0,0,0,3,-3,2,0,0,0,2,-1
1017,Taiwan,Asia,c,2017,F,1,1,12,15,10,0,37,16,11,14,13,54,91
1018,Tajikistan,Eurasia,c,2017,NF,7,6,0,0,1,0,1,2,2,2,4,10,11
1019,Tanzania,SSA,c,2017,PF,3,4,7,11,7,0,25,9,6,9,9,33,58
1020,Thailand,Asia,c,2017,NF,6,5,1,3,3,0,7,6,4,5,10,25,32
1021,The Gambia,SSA,c,2017,NF,6,6,3,5,0,0,8,3,2,1,6,12,20
1022,Tibet,Asia,t,2017,NF,7,7,0,0,1,3,-2,0,0,0,3,3,1
1023,Timor-Leste,Asia,c,2017,PF,3,3,11,12,6,0,29,12,8,7,9,36,65
1024,Togo,SSA,c,2017,PF,4,4,6,7,5,0,18,9,7,7,7,30,48
1025,Tonga,Asia,c,2017,F,2,2,9,14,7,0,30,12,9,11,12,44,74
1026,Transnistria,Eurasia,t,2017,NF,6,6,3,5,2,0,10,5,2,2,5,14,24
1027,Trinidad and Tobago,Americas,c,2017,F,2,2,11,13,9,0,33,15,11,9,13,48,81
1028,Tunisia,MENA,c,2017,F,1,3,11,16,9,0,36,13,9,9,11,42,78
1029,Turkey,Europe,c,2017,PF,4,5,8,7,3,0,18,6,3,4,7,20,38
1030,Turkmenistan,Eurasia,c,2017,NF,7,7,0,0,0,0,0,1,0,0,3,4,4
1031,Tuvalu,Asia,c,2017,F,1,1,12,15,10,0,37,16,12,15,14,57,94
1032,Uganda,SSA,c,2017,NF,6,5,3,5,3,0,11,9,4,4,7,24,35
1033,Ukraine,Eurasia,c,2017,PF,3,3,9,10,6,0,25,11,9,6,10,36,61
1034,United Arab Emirates,MENA,c,2017,NF,6,6,1,2,2,0,7,4,2,3,4,13,20
1035,United Kingdom,Europe,c,2017,F,1,1,12,16,12,0,40,14,12,14,15,55,95
1036,United States,Americas,c,2017,F,1,1,11,14,11,0,36,16,10,12,15,53,89
1037,Uruguay,Americas,c,2017,F,1,1,12,16,12,0,40,16,12,15,15,58,98
1038,Uzbekistan,Eurasia,c,2017,NF,7,7,0,0,0,0,0,0,0,0,3,3,3
1039,Vanuatu,Asia,c,2017,F,2,2,10,15,7,0,32,15,11,11,11,48,80
1040,Venezuela,Americas,c,2017,NF,6,5,5,6,0,0,11,8,3,1,7,19,30
1041,Vietnam,Asia,c,2017,NF,7,5,0,1,2,0,3,4,1,4,8,17,20
1042,West Bank,MENA,t,2017,NF,7,5,2,4,2,3,5,8,5,5,5,23,28
1043,Western Sahara,MENA,t,2017,NF,7,7,0,0,0,3,-3,3,0,0,4,7,4
1044,Yemen,MENA,c,2017,NF,7,6,0,1,1,0,2,5,3,2,2,12,14
1045,Zambia,SSA,c,2017,PF,4,4,6,11,6,0,23,10,7,8,8,33,56
1046,Zimbabwe,SSA,c,2017,PF,5,5,3,6,3,0,12,8,4,3,5,20,32
1047,Abkhazia,Eurasia,t,2016,PF,4,5,6,8,5,0,19,8,6,4,5,23,42
1048,Afghanistan,Asia,c,2016,NF,6,6,2,6,2,0,10,6,4,2,2,14,24
1049,Albania,Europe,c,2016,PF,3,3,8,13,6,0,27,13,9,9,9,40,67
1050,Algeria,MENA,c,2016,NF,6,5,4,4,3,0,11,7,5,5,7,24,35
1051,Andorra,Europe,c,2016,F,1,1,12,15,12,0,39,16,11,15,15,57,96
1052,Angola,SSA,c,2016,NF,6,6,3,6,1,0,10,5,3,3,3,14,24
1053,Antigua and Barbuda,Americas,c,2016,F,2,2,12,13,8,0,33,14,9,13,13,49,82
1054,Argentina,Americas,c,2016,F,2,2,11,14,6,0,31,14,11,10,13,48,79
1055,Armenia,Eurasia,c,2016,PF,5,4,5,7,4,0,16,9,6,6,9,30,46
1056,Australia,Asia,c,2016,F,1,1,12,16,12,0,40,16,12,15,15,58,98
1057,Austria,Europe,c,2016,F,1,1,12,15,10,0,37,16,12,15,15,58,95
1058,Azerbaijan,Eurasia,c,2016,NF,7,6,1,3,1,0,5,3,1,2,5,11,16
1059,Bahamas,Americas,c,2016,F,1,1,12,16,10,0,38,16,12,13,13,54,92
1060,Bahrain,MENA,c,2016,NF,7,6,2,2,3,3,4,2,1,1,6,10,14
1061,Bangladesh,Asia,c,2016,PF,4,4,7,9,5,0,21,7,6,6,9,28,49
1062,Barbados,Americas,c,2016,F,1,1,12,16,12,0,40,16,12,15,15,58,98
1063,Belarus,Eurasia,c,2016,NF,7,6,0,3,1,0,4,3,1,2,7,13,17
1064,Belgium,Europe,c,2016,F,1,1,12,16,12,0,40,15,12,14,15,56,96
1065,Belize,Americas,c,2016,F,1,2,12,14,10,0,36,15,11,12,13,51,87
1066,Benin,SSA,c,2016,F,2,2,9,16,8,0,33,15,12,12,10,49,82
1067,Bhutan,Asia,c,2016,PF,3,4,10,10,10,1,29,9,4,6,8,27,56
1068,Bolivia,Americas,c,2016,PF,3,3,11,11,7,0,29,14,9,6,10,39,68
1069,Bosnia and Herzegovina,Europe,c,2016,PF,4,3,8,10,4,0,22,10,7,8,10,35,57
1070,Botswana,SSA,c,2016,F,3,2,10,10,8,0,28,12,10,12,11,45,73
1071,Brazil,Americas,c,2016,F,2,2,11,14,8,0,33,15,10,10,13,48,81
1072,Brunei,Asia,c,2016,NF,6,5,0,3,3,0,7,6,3,6,7,22,29
1073,Bulgaria,Europe,c,2016,F,2,2,11,14,8,0,33,14,11,10,12,47,80
1074,Burkina Faso,SSA,c,2016,PF,4,3,6,9,6,0,21,14,8,8,8,38,59
1075,Burundi,SSA,c,2016,NF,7,6,1,4,0,0,5,6,2,1,5,14,19
1076,Cambodia,Asia,c,2016,NF,6,5,4,4,3,0,11,9,3,3,6,21,32
1077,Cameroon,SSA,c,2016,NF,6,6,3,3,3,0,9,7,3,1,4,15,24
1078,Canada,Americas,c,2016,F,1,1,12,16,12,0,40,16,12,15,16,59,99
1079,Cape Verde,SSA,c,2016,F,1,1,12,15,10,0,37,15,11,14,13,53,90
1080,Central African Republic,SSA,c,2016,NF,7,7,1,1,0,1,1,4,1,0,1,6,7
1081,Chad,SSA,c,2016,NF,7,6,2,1,1,0,4,7,5,1,3,16,20
1082,Chile,Americas,c,2016,F,1,1,12,15,11,0,38,16,12,14,15,57,95
1083,China,Asia,c,2016,NF,7,6,0,1,2,2,1,4,3,2,6,15,16
1084,Colombia,Americas,c,2016,PF,3,4,10,11,8,0,29,12,5,7,10,34,63
1085,Comoros,SSA,c,2016,PF,3,4,9,11,4,0,24,10,7,8,6,31,55
1086,Congo (Brazzaville),SSA,c,2016,NF,6,5,1,2,3,0,6,7,6,2,7,22,28
1087,Congo (Kinshasa),SSA,c,2016,NF,6,6,3,4,2,0,9,8,3,0,5,16,25
1088,Costa Rica,Americas,c,2016,F,1,1,12,15,10,0,37,16,11,13,13,53,90
1089,Cote d'Ivoire,SSA,c,2016,PF,4,4,7,8,5,0,20,11,7,6,7,31,51
1090,Crimea,Eurasia,t,2016,NF,7,6,0,0,0,1,-1,3,1,0,6,10,9
1091,Croatia,Europe,c,2016,F,1,2,12,15,10,0,37,14,12,11,13,50,87
1092,Cuba,Americas,c,2016,NF,7,6,0,0,1,0,1,5,0,3,6,14,15
1093,Cyprus,Europe,c,2016,F,1,1,11,16,11,0,38,15,12,15,14,56,94
1094,Czech Republic,Europe,c,2016,F,1,1,12,15,11,0,38,16,12,14,15,57,95
1095,Denmark,Europe,c,2016,F,1,1,12,16,12,0,40,16,12,15,15,58,98
1096,Djibouti,SSA,c,2016,NF,6,5,3,3,3,0,9,6,3,4,6,19,28
1097,Dominica,Americas,c,2016,F,1,1,12,16,10,0,38,15,12,15,15,57,95
1098,Dominican Republic,Americas,c,2016,PF,3,3,10,10,9,0,29,14,10,8,9,41,70
1099,Ecuador,Americas,c,2016,PF,3,3,7,11,6,0,24,12,7,6,10,35,59
1100,Egypt,MENA,c,2016,NF,6,5,3,4,2,0,9,5,4,2,7,18,27
1101,El Salvador,Americas,c,2016,F,2,3,10,14,9,0,33,12,8,8,8,36,69
1102,Equatorial Guinea,SSA,c,2016,NF,7,7,0,1,0,0,1,4,0,0,3,7,8
1103,Eritrea,SSA,c,2016,NF,7,7,0,0,1,0,1,0,0,0,2,2,3
1104,Estonia,Europe,c,2016,F,1,1,12,15,11,0,38,16,12,14,14,56,94
1105,Ethiopia,SSA,c,2016,NF,7,6,1,0,3,0,4,3,0,3,5,11,15
1106,Fiji,Asia,c,2016,PF,3,3,9,11,7,0,27,11,5,9,10,35,62
1107,Finland,Europe,c,2016,F,1,1,12,16,12,0,40,16,12,16,16,60,100
1108,France,Europe,c,2016,F,1,1,12,15,11,0,38,14,11,13,15,53,91
1109,Gabon,SSA,c,2016,NF,6,5,2,4,3,0,9,10,4,6,5,25,34
1110,Gaza Strip,MENA,t,2016,NF,7,6,0,2,1,0,3,4,3,0,2,9,12
1111,Georgia,Eurasia,c,2016,PF,3,3,9,11,7,0,27,11,8,8,10,37,64
1112,Germany,Europe,c,2016,F,1,1,12,15,12,0,39,15,12,14,15,56,95
1113,Ghana,SSA,c,2016,F,1,2,12,15,10,0,37,14,11,11,10,46,83
1114,Greece,Europe,c,2016,F,2,2,12,15,8,0,35,14,11,10,13,48,83
1115,Grenada,Americas,c,2016,F,1,2,12,16,10,0,38,15,11,12,13,51,89
1116,Guatemala,Americas,c,2016,PF,4,4,8,10,5,0,23,12,6,5,8,31,54
1117,Guinea,SSA,c,2016,PF,5,5,6,8,3,0,17,9,5,4,5,23,40
1118,Guinea-Bissau,SSA,c,2016,PF,5,5,7,8,1,0,16,10,5,3,5,23,39
1119,Guyana,Americas,c,2016,F,2,3,11,13,8,0,32,15,10,8,9,42,74
1120,Haiti,Americas,c,2016,PF,5,5,4,8,5,0,17,10,4,4,6,24,41
1121,Honduras,Americas,c,2016,PF,4,4,7,9,3,0,19,9,5,4,8,26,45
1122,Hong Kong,Asia,t,2016,PF,5,2,3,7,6,0,16,12,8,14,13,47,63
1123,Hungary,Europe,c,2016,F,2,2,9,15,8,0,32,13,11,10,13,47,79
1124,Iceland,Europe,c,2016,F,1,1,12,16,12,0,40,16,12,16,16,60,100
1125,India,Asia,c,2016,F,2,3,12,14,9,0,35,13,10,9,10,42,77
1126,Indian Kashmir,Asia,t,2016,PF,4,4,9,9,4,0,22,9,6,6,8,29,51
1127,Indonesia,Asia,c,2016,PF,2,4,11,14,6,0,31,12,8,5,9,34,65
1128,Iran,MENA,c,2016,NF,6,6,3,2,2,0,7,2,1,3,4,10,17
1129,Iraq,MENA,c,2016,NF,5,6,8,5,2,3,12,5,6,0,4,15,27
1130,Ireland,Europe,c,2016,F,1,1,12,16,11,0,39,16,12,14,15,57,96
1131,Israel,MENA,c,2016,F,1,2,12,14,10,0,36,12,10,11,11,44,80
1132,Italy,Europe,c,2016,F,1,1,12,14,10,0,36,15,12,12,14,53,89
1133,Jamaica,Americas,c,2016,F,2,3,12,13,9,0,34,15,9,7,10,41,75
1134,Japan,Asia,c,2016,F,1,1,12,16,12,0,40,15,12,15,14,56,96
1135,Jordan,MENA,c,2016,NF,6,5,2,6,3,0,11,7,4,6,8,25,36
1136,Kazakhstan,Eurasia,c,2016,NF,6,5,2,3,1,0,6,4,2,4,8,18,24
1137,Kenya,SSA,c,2016,PF,4,4,7,10,5,0,22,11,6,5,7,29,51
1138,Kiribati,Asia,c,2016,F,1,1,12,16,8,0,36,15,12,15,13,55,91
1139,Kosovo,Europe,c,2016,PF,3,4,9,10,5,0,24,9,6,6,7,28,52
1140,Kuwait,MENA,c,2016,PF,5,5,2,7,4,0,13,6,4,7,6,23,36
1141,Kyrgyzstan,Eurasia,c,2016,PF,5,5,6,6,4,2,14,9,4,4,7,24,38
1142,Laos,Asia,c,2016,NF,7,6,0,0,1,0,1,4,0,2,5,11,12
1143,Latvia,Europe,c,2016,F,2,2,12,14,9,0,35,15,12,12,12,51,86
1144,Lebanon,MENA,c,2016,PF,5,4,2,9,2,0,13,11,7,5,7,30,43
1145,Lesotho,SSA,c,2016,PF,3,3,10,12,6,0,28,14,7,9,9,39,67
1146,Liberia,SSA,c,2016,PF,3,4,9,12,7,0,28,10,8,7,8,33,61
1147,Libya,MENA,c,2016,NF,6,6,4,2,0,0,6,6,3,1,4,14,20
1148,Liechtenstein,Europe,c,2016,F,1,1,12,15,12,0,39,16,12,15,16,59,98
1149,Lithuania,Europe,c,2016,F,1,1,12,16,10,0,38,16,11,13,13,53,91
1150,Luxembourg,Europe,c,2016,F,1,1,12,16,10,0,38,16,12,16,16,60,98
1151,Macedonia,Europe,c,2016,PF,4,3,6,10,6,0,22,10,8,7,10,35,57
1152,Madagascar,SSA,c,2016,PF,3,4,9,10,5,0,24,10,8,6,8,32,56
1153,Malawi,SSA,c,2016,PF,3,3,8,12,7,0,27,13,8,9,7,37,64
1154,Malaysia,Asia,c,2016,PF,4,4,6,7,5,0,18,7,6,5,9,27,45
1155,Maldives,Asia,c,2016,PF,4,5,7,6,6,0,19,6,5,6,7,24,43
1156,Mali,SSA,c,2016,PF,5,4,6,7,4,0,17,12,6,6,4,28,45
1157,Malta,Europe,c,2016,F,1,1,12,16,11,0,39,16,12,15,14,57,96
1158,Marshall Islands,Asia,c,2016,F,1,1,12,15,10,0,37,16,11,15,13,55,92
1159,Mauritania,SSA,c,2016,NF,6,5,3,2,4,0,9,9,4,4,4,21,30
1160,Mauritius,SSA,c,2016,F,1,2,12,15,11,0,38,15,12,13,12,52,90
1161,Mexico,Americas,c,2016,PF,3,3,9,12,7,0,28,13,8,6,10,37,65
1162,Micronesia,Asia,c,2016,F,1,1,12,15,10,0,37,16,11,15,14,56,93
1163,Moldova,Eurasia,c,2016,PF,3,3,10,11,4,0,25,11,8,7,9,35,60
1164,Monaco,Europe,c,2016,F,2,1,10,11,10,0,31,16,12,15,14,57,88
1165,Mongolia,Asia,c,2016,F,1,2,11,16,9,0,36,15,11,12,12,50,86
1166,Montenegro,Europe,c,2016,PF,3,3,9,11,7,0,27,12,9,10,12,43,70
1167,Morocco,MENA,c,2016,PF,5,4,5,7,3,0,15,8,5,6,7,26,41
1168,Mozambique,SSA,c,2016,PF,4,4,6,10,6,0,22,11,7,7,9,34,56
1169,Myanmar,Asia,c,2016,NF,6,5,3,8,3,3,11,7,4,1,5,17,28
1170,Nagorno-Karabakh,Eurasia,t,2016,PF,5,5,6,6,3,0,15,6,3,4,5,18,33
1171,Namibia,SSA,c,2016,F,2,2,10,11,9,0,30,14,12,11,10,47,77
1172,Nauru,Asia,c,2016,F,2,2,12,15,8,0,35,13,10,12,14,49,84
1173,Nepal,Asia,c,2016,PF,3,4,9,11,5,0,25,9,5,5,7,26,51
1174,Netherlands,Europe,c,2016,F,1,1,12,16,12,0,40,16,12,15,16,59,99
1175,New Zealand,Asia,c,2016,F,1,1,12,16,12,0,40,16,12,15,15,58,98
1176,Nicaragua,Americas,c,2016,PF,4,3,6,7,6,0,19,12,6,7,10,35,54
1177,Niger,SSA,c,2016,PF,3,4,8,9,7,0,24,11,6,5,6,28,52
1178,Nigeria,SSA,c,2016,PF,4,5,9,10,5,1,23,9,7,4,5,25,48
1179,North Korea,Asia,c,2016,NF,7,7,0,0,0,0,0,0,0,0,3,3,3
1180,Northern Cyprus,Europe,t,2016,F,2,2,11,12,9,0,32,14,9,12,12,47,79
1181,Norway,Europe,c,2016,F,1,1,12,16,12,0,40,16,12,16,16,60,100
1182,Oman,MENA,c,2016,NF,6,5,2,2,2,0,8,5,3,4,5,17,25
1183,Pakistan,Asia,c,2016,PF,4,5,7,8,5,0,20,5,6,4,6,21,41
1184,Pakistani Kashmir,Asia,t,2016,NF,6,5,4,4,3,2,9,6,4,3,6,19,28
1185,Palau,Asia,c,2016,F,1,1,12,15,10,0,37,16,11,15,13,55,92
1186,Panama,Americas,c,2016,F,2,2,12,15,8,0,35,15,11,10,12,48,83
1187,Papua New Guinea,Asia,c,2016,PF,4,3,9,10,4,0,23,12,9,7,8,36,59
1188,Paraguay,Americas,c,2016,PF,3,3,10,12,5,0,27,12,8,7,10,37,64
1189,Peru,Americas,c,2016,F,2,3,10,13,7,0,30,15,8,8,10,41,71
1190,Philippines,Asia,c,2016,PF,3,3,9,11,7,0,27,14,9,5,10,38,65
1191,Poland,Europe,c,2016,F,1,1,12,16,10,0,38,16,12,13,14,55,93
1192,Portugal,Europe,c,2016,F,1,1,12,16,11,0,39,16,12,15,15,58,97
1193,Puerto Rico,Americas,t,2016,F,1,1,12,15,10,0,37,16,11,12,14,53,90
1194,Qatar,MENA,c,2016,NF,6,5,2,2,3,0,9,8,2,4,4,18,27
1195,Romania,Europe,c,2016,F,2,2,11,14,9,0,34,14,11,12,12,49,83
1196,Russia,Eurasia,c,2016,NF,6,6,1,3,3,0,7,3,3,2,7,15,22
1197,Rwanda,SSA,c,2016,NF,6,6,2,1,5,0,8,4,2,3,7,16,24
1198,Samoa,Asia,c,2016,F,2,2,9,13,9,0,31,14,10,13,12,49,80
1199,San Marino,Europe,c,2016,F,1,1,12,16,12,0,40,16,12,16,16,60,100
1200,Sao Tome and Principe,SSA,c,2016,F,2,2,11,14,9,0,34,15,10,12,10,47,81
1201,Saudi Arabia,MENA,c,2016,NF,7,7,0,0,1,0,3,3,0,2,2,7,10
1202,Senegal,SSA,c,2016,F,2,2,11,13,9,0,33,15,10,10,10,45,78
1203,Serbia,Europe,c,2016,F,2,2,10,13,7,0,30,14,11,10,13,48,78
1204,Seychelles,SSA,c,2016,PF,3,3,9,10,7,0,26,11,9,11,11,42,68
1205,Sierra Leone,SSA,c,2016,PF,3,3,10,11,7,0,28,12,7,9,9,37,65
1206,Singapore,Asia,c,2016,PF,4,4,4,8,7,0,19,9,4,7,12,32,51
1207,Slovakia,Europe,c,2016,F,1,1,12,15,9,0,36,15,12,12,14,53,89
1208,Slovenia,Europe,c,2016,F,1,1,12,16,11,0,39,14,12,14,13,53,92
1209,Solomon Islands,Asia,c,2016,PF,3,3,9,10,6,0,25,14,9,8,12,43,68
1210,Somalia,SSA,c,2016,NF,7,7,0,0,0,0,0,1,0,0,1,2,2
1211,Somaliland,SSA,t,2016,PF,5,5,2,9,4,0,15,7,5,7,6,25,40
1212,South Africa,SSA,c,2016,F,2,2,12,13,8,0,33,15,12,9,10,46,79
1213,South Korea,Asia,c,2016,F,2,2,11,13,10,0,34,12,11,13,13,49,83
1214,South Ossetia,Eurasia,t,2016,NF,7,6,2,2,0,2,2,4,1,1,3,9,11
1215,South Sudan,SSA,c,2016,NF,7,6,3,1,1,3,2,4,3,1,4,12,14
1216,Spain,Europe,c,2016,F,1,1,12,16,11,0,39,15,11,15,15,56,95
1217,Sri Lanka,Asia,c,2016,PF,4,4,8,10,6,1,23,9,8,7,8,32,55
1218,St. Kitts and Nevis,Americas,c,2016,F,2,1,10,16,9,0,35,15,12,13,13,53,88
1219,St. Lucia,Americas,c,2016,F,1,1,12,16,11,0,39,15,12,12,14,53,92
1220,St. Vincent and the Grenadines,Americas,c,2016,F,1,1,11,16,10,0,37,15,12,13,14,54,91
1221,Sudan,SSA,c,2016,NF,7,7,2,3,1,4,2,2,1,0,1,4,6
1222,Suriname,Americas,c,2016,F,2,3,12,14,8,0,34,15,11,7,10,43,77
1223,Swaziland,SSA,c,2016,NF,7,5,0,1,0,0,1,7,2,4,4,17,18
1224,Sweden,Europe,c,2016,F,1,1,12,16,12,0,40,16,12,16,16,60,100
1225,Switzerland,Europe,c,2016,F,1,1,12,15,12,0,39,15,12,15,15,57,96
1226,Syria,MENA,c,2016,NF,7,7,0,0,0,3,-3,2,0,0,0,2,-1
1227,Taiwan,Asia,c,2016,F,1,2,12,15,10,0,37,14,11,14,13,52,89
1228,Tajikistan,Eurasia,c,2016,NF,7,6,1,0,1,0,2,4,3,3,4,14,16
1229,Tanzania,SSA,c,2016,PF,3,4,8,12,7,0,27,9,6,9,9,33,60
1230,Thailand,Asia,c,2016,NF,6,5,1,3,3,0,7,6,4,5,10,25,32
1231,The Gambia,SSA,c,2016,NF,7,6,1,4,0,0,5,3,3,1,6,13,18
1232,Tibet,Asia,t,2016,NF,7,7,0,0,1,3,-2,0,0,0,3,3,1
1233,Timor-Leste,Asia,c,2016,PF,3,3,11,12,6,0,29,12,8,7,9,36,65
1234,Togo,SSA,c,2016,PF,4,4,6,7,5,0,18,9,7,7,7,30,48
1235,Tonga,Asia,c,2016,F,2,2,11,14,6,0,31,13,8,11,12,44,75
1236,Transnistria,Eurasia,t,2016,NF,6,6,3,5,2,0,10,5,2,2,5,14,24
1237,Trinidad and Tobago,Americas,c,2016,F,2,2,11,13,9,0,33,15,11,9,13,48,81
1238,Tunisia,MENA,c,2016,F,1,3,12,16,9,0,37,13,9,9,11,42,79
1239,Turkey,Europe,c,2016,PF,3,4,9,9,6,0,24,8,6,6,9,29,53
1240,Turkmenistan,Eurasia,c,2016,NF,7,7,0,0,0,0,0,1,0,0,3,4,4
1241,Tuvalu,Asia,c,2016,F,1,1,12,15,10,0,37,16,12,15,14,57,94
1242,Uganda,SSA,c,2016,NF,6,5,3,5,3,0,11,9,4,5,7,25,36
1243,Ukraine,Eurasia,c,2016,PF,3,3,9,10,6,0,25,11,9,6,10,36,61
1244,United Arab Emirates,MENA,c,2016,NF,6,6,1,2,2,0,7,4,2,3,4,13,20
1245,United Kingdom,Europe,c,2016,F,1,1,12,16,12,0,40,13,12,15,15,55,95
1246,United States,Americas,c,2016,F,1,1,11,15,10,0,36,15,11,13,15,54,90
1247,Uruguay,Americas,c,2016,F,1,1,12,16,12,0,40,16,12,15,15,58,98
1248,Uzbekistan,Eurasia,c,2016,NF,7,7,0,0,0,0,0,0,0,0,3,3,3
1249,Vanuatu,Asia,c,2016,F,2,2,9,15,7,0,31,15,11,10,11,47,78
1250,Venezuela,Americas,c,2016,PF,5,5,5,8,2,0,15,8,3,1,8,20,35
1251,Vietnam,Asia,c,2016,NF,7,5,0,1,2,0,3,4,1,4,8,17,20
1252,West Bank,MENA,t,2016,NF,6,5,2,5,2,3,6,9,5,5,5,24,30
1253,Western Sahara,MENA,t,2016,NF,7,7,0,0,0,3,-3,3,0,0,4,7,4
1254,Yemen,MENA,c,2016,NF,7,6,2,1,1,0,4,5,3,2,3,13,17
1255,Zambia,SSA,c,2016,PF,3,4,8,11,7,0,26,11,7,8,8,34,60
1256,Zimbabwe,SSA,c,2016,PF,5,5,3,6,3,0,12,8,4,3,5,20,32
1257,Abkhazia,Eurasia,t,2015,PF,4,5,6,8,4,0,18,8,6,4,5,23,41
1258,Afghanistan,Asia,c,2015,NF,6,6,3,6,2,0,11,5,4,2,2,13,24
1259,Albania,Europe,c,2015,PF,3,3,8,13,6,0,27,13,9,9,9,40,67
1260,Algeria,MENA,c,2015,NF,6,5,4,4,3,0,11,7,4,5,7,23,34
1261,Andorra,Europe,c,2015,F,1,1,12,15,12,0,39,16,11,15,15,57,96
1262,Angola,SSA,c,2015,NF,6,5,3,6,1,0,10,7,4,4,3,18,28
1263,Antigua and Barbuda,Americas,c,2015,F,2,2,11,13,7,0,31,14,9,13,13,49,80
1264,Argentina,Americas,c,2015,F,2,2,11,14,6,0,31,14,11,11,13,49,80
1265,Armenia,Eurasia,c,2015,PF,5,4,5,7,4,0,16,9,6,6,9,30,46
1266,Australia,Asia,c,2015,F,1,1,12,15,12,0,39,16,12,15,15,58,97
1267,Austria,Europe,c,2015,F,1,1,12,15,11,0,38,16,12,15,15,58,96
1268,Azerbaijan,Eurasia,c,2015,NF,6,6,1,3,2,0,6,4,1,3,6,14,20
1269,Bahamas,Americas,c,2015,F,1,1,12,16,10,0,38,16,12,15,15,58,96
1270,Bahrain,MENA,c,2015,NF,7,6,2,2,3,2,5,2,1,1,6,10,15
1271,Bangladesh,Asia,c,2015,PF,4,4,7,9,5,0,21,8,6,6,9,29,50
1272,Barbados,Americas,c,2015,F,1,1,12,16,12,0,40,16,12,16,15,59,99
1273,Belarus,Eurasia,c,2015,NF,7,6,0,3,1,0,4,3,1,1,5,10,14
1274,Belgium,Europe,c,2015,F,1,1,12,16,12,0,40,15,12,15,15,57,97
1275,Belize,Americas,c,2015,F,1,2,12,14,10,0,36,15,11,12,13,51,87
1276,Benin,SSA,c,2015,F,2,2,8,16,8,0,32,15,12,12,10,49,81
1277,Bhutan,Asia,c,2015,PF,3,4,10,10,10,1,29,9,4,6,8,27,56
1278,Bolivia,Americas,c,2015,PF,3,3,11,11,7,0,29,14,9,6,10,39,68
1279,Bosnia and Herzegovina,Europe,c,2015,PF,4,3,8,10,5,0,23,10,7,10,10,37,60
1280,Botswana,SSA,c,2015,F,3,2,10,10,8,0,28,12,10,12,11,45,73
1281,Brazil,Americas,c,2015,F,2,2,11,14,8,0,33,15,10,10,13,48,81
1282,Brunei,Asia,c,2015,NF,6,5,0,3,3,0,7,6,3,6,8,23,30
1283,Bulgaria,Europe,c,2015,F,2,2,11,14,8,0,33,14,11,10,11,46,79
1284,Burkina Faso,SSA,c,2015,PF,6,3,2,6,1,0,9,13,8,7,8,36,45
1285,Burundi,SSA,c,2015,NF,6,5,4,5,2,0,11,8,3,4,6,21,32
1286,Cambodia,Asia,c,2015,NF,6,5,4,4,3,0,11,9,3,2,6,20,31
1287,Cameroon,SSA,c,2015,NF,6,6,3,3,3,0,9,7,3,2,4,16,25
1288,Canada,Americas,c,2015,F,1,1,12,16,11,0,39,16,12,15,16,59,98
1289,Cape Verde,SSA,c,2015,F,1,1,12,15,10,0,37,15,11,14,13,53,90
1290,Central African Republic,SSA,c,2015,NF,7,7,0,1,0,1,0,4,1,0,1,6,6
1291,Chad,SSA,c,2015,NF,7,6,3,1,1,0,5,7,4,2,3,16,21
1292,Chile,Americas,c,2015,F,1,1,12,15,12,0,39,16,11,14,15,56,95
1293,China,Asia,c,2015,NF,7,6,0,1,2,1,2,4,3,2,6,15,17
1294,Colombia,Americas,c,2015,PF,3,4,10,11,8,0,29,12,5,7,10,34,63
1295,Comoros,SSA,c,2015,PF,3,4,9,11,5,0,25,10,6,8,6,30,55
1296,Congo (Brazzaville),SSA,c,2015,NF,6,5,1,3,3,0,7,8,6,2,7,23,30
1297,Congo (Kinshasa),SSA,c,2015,NF,6,6,3,4,2,0,9,8,3,0,5,16,25
1298,Costa Rica,Americas,c,2015,F,1,1,12,15,10,0,37,16,11,13,13,53,90
1299,Cote d'Ivoire,SSA,c,2015,PF,5,4,6,7,4,0,17,10,7,6,6,29,46
1300,Crimea,Eurasia,t,2015,NF,7,6,0,0,0,1,-1,3,1,0,7,11,10
1301,Croatia,Europe,c,2015,F,1,2,12,15,9,0,36,14,12,11,13,50,86
1302,Cuba,Americas,c,2015,NF,7,6,0,0,1,0,1,4,0,3,6,13,14
1303,Cyprus,Europe,c,2015,F,1,1,11,16,10,0,37,15,12,15,14,56,93
1304,Czech Republic,Europe,c,2015,F,1,1,12,15,11,0,38,16,12,14,15,57,95
1305,Denmark,Europe,c,2015,F,1,1,12,16,12,0,40,16,12,15,15,58,98
1306,Djibouti,SSA,c,2015,NF,6,5,3,3,3,0,9,6,3,4,6,19,28
1307,Dominica,Americas,c,2015,F,1,1,12,16,10,0,38,15,12,15,15,57,95
1308,Dominican Republic,Americas,c,2015,F,2,3,10,11,9,0,30,15,10,8,10,43,73
1309,Ecuador,Americas,c,2015,PF,3,3,7,11,6,0,24,12,7,6,10,35,59
1310,Egypt,MENA,c,2015,NF,6,5,2,4,2,0,8,5,4,2,7,18,26
1311,El Salvador,Americas,c,2015,F,2,3,12,14,9,0,35,15,8,8,9,40,75
1312,Equatorial Guinea,SSA,c,2015,NF,7,7,0,1,0,0,1,4,0,0,3,7,8
1313,Eritrea,SSA,c,2015,NF,7,7,0,0,1,0,1,0,0,0,2,2,3
1314,Estonia,Europe,c,2015,F,1,1,12,15,12,0,39,16,12,14,14,56,95
1315,Ethiopia,SSA,c,2015,NF,6,6,1,2,4,0,7,3,0,3,5,11,18
1316,Fiji,Asia,c,2015,PF,3,4,9,11,6,0,26,11,4,9,10,34,60
1317,Finland,Europe,c,2015,F,1,1,12,16,12,0,40,16,12,16,16,60,100
1318,France,Europe,c,2015,F,1,1,12,15,11,0,38,15,12,15,15,57,95
1319,Gabon,SSA,c,2015,NF,6,5,2,4,3,0,9,10,4,6,5,25,34
1320,Gaza Strip,MENA,t,2015,NF,7,6,2,2,1,0,5,5,3,0,2,10,15
1321,Georgia,Eurasia,c,2015,PF,3,3,9,10,7,0,26,12,8,8,10,38,64
1322,Germany,Europe,c,2015,F,1,1,12,15,12,0,39,15,12,15,15,57,96
1323,Ghana,SSA,c,2015,F,1,2,12,15,10,0,37,14,11,12,10,47,84
1324,Greece,Europe,c,2015,F,2,2,12,15,8,0,35,14,11,10,13,48,83
1325,Grenada,Americas,c,2015,F,1,2,12,16,10,0,38,15,11,12,13,51,89
1326,Guatemala,Americas,c,2015,PF,3,4,9,10,5,0,24,12,6,5,8,31,55
1327,Guinea,SSA,c,2015,PF,5,5,6,8,3,0,17,9,6,4,5,24,41
1328,Guinea-Bissau,SSA,c,2015,PF,5,5,8,8,1,0,17,10,5,3,5,23,40
1329,Guyana,Americas,c,2015,F,2,3,11,13,6,0,30,15,10,7,9,41,71
1330,Haiti,Americas,c,2015,PF,5,5,4,8,5,0,17,10,4,4,6,24,41
1331,Honduras,Americas,c,2015,PF,4,4,7,9,4,0,20,10,6,5,8,29,49
1332,Hong Kong,Asia,t,2015,PF,5,2,3,7,6,0,16,13,8,15,13,49,65
1333,Hungary,Europe,c,2015,F,2,2,9,15,8,0,32,14,11,11,14,50,82
1334,Iceland,Europe,c,2015,F,1,1,12,16,11,0,39,16,12,16,16,60,99
1335,India,Asia,c,2015,F,2,3,12,14,9,0,35,13,11,9,10,43,78
1336,Indian Kashmir,Asia,t,2015,PF,4,4,9,9,4,0,22,9,6,6,8,29,51
1337,Indonesia,Asia,c,2015,PF,2,4,10,14,6,0,30,12,8,5,9,34,64
1338,Iran,MENA,c,2015,NF,6,6,3,2,2,0,7,2,1,3,4,10,17
1339,Iraq,MENA,c,2015,NF,6,6,8,5,1,3,11,5,4,0,4,13,24
1340,Ireland,Europe,c,2015,F,1,1,12,16,11,0,39,16,12,15,15,58,97
1341,Israel,MENA,c,2015,F,1,2,12,14,10,0,36,12,10,11,11,44,80
1342,Italy,Europe,c,2015,F,1,1,12,14,10,0,36,15,12,12,14,53,89
1343,Jamaica,Americas,c,2015,F,2,3,12,13,9,0,34,15,9,6,10,40,74
1344,Japan,Asia,c,2015,F,1,1,12,15,12,0,39,15,11,15,14,55,94
1345,Jordan,MENA,c,2015,NF,6,5,2,6,3,0,11,7,4,6,8,25,36
1346,Kazakhstan,Eurasia,c,2015,NF,6,5,2,3,1,0,6,4,2,4,8,18,24
1347,Kenya,SSA,c,2015,PF,4,4,7,10,5,0,22,11,6,5,7,29,51
1348,Kiribati,Asia,c,2015,F,1,1,12,16,8,0,36,15,12,15,13,55,91
1349,Kosovo,Europe,c,2015,PF,4,4,9,10,4,0,23,9,6,6,8,29,52
1350,Kuwait,MENA,c,2015,PF,5,5,2,7,5,0,14,6,4,7,6,23,37
1351,Kyrgyzstan,Eurasia,c,2015,PF,5,5,6,6,4,2,14,9,4,4,7,24,38
1352,Laos,Asia,c,2015,NF,7,6,0,0,1,0,1,4,0,2,5,11,12
1353,Latvia,Europe,c,2015,F,2,2,12,14,8,0,34,15,12,12,12,51,85
1354,Lebanon,MENA,c,2015,PF,5,4,2,9,3,0,14,11,7,5,7,30,44
1355,Lesotho,SSA,c,2015,F,2,3,10,12,8,0,30,14,7,11,9,41,71
1356,Liberia,SSA,c,2015,PF,3,4,9,11,6,0,26,10,7,6,7,30,56
1357,Libya,MENA,c,2015,NF,6,6,5,3,0,0,8,6,3,1,5,15,23
1358,Liechtenstein,Europe,c,2015,F,1,1,12,15,12,0,39,16,12,15,16,59,98
1359,Lithuania,Europe,c,2015,F,1,1,12,16,10,0,38,16,11,13,13,53,91
1360,Luxembourg,Europe,c,2015,F,1,1,12,16,10,0,38,16,12,16,16,60,98
1361,Macedonia,Europe,c,2015,PF,4,3,7,10,6,0,23,11,8,8,10,37,60
1362,Madagascar,SSA,c,2015,PF,4,4,9,9,4,0,22,9,8,6,7,30,52
1363,Malawi,SSA,c,2015,PF,3,4,8,12,7,0,27,11,7,9,7,34,61
1364,Malaysia,Asia,c,2015,PF,4,4,6,7,6,0,19,7,6,5,9,27,46
1365,Maldives,Asia,c,2015,PF,4,4,7,7,6,0,20,6,7,7,8,28,48
1366,Mali,SSA,c,2015,PF,5,4,6,7,4,0,17,11,6,6,4,27,44
1367,Malta,Europe,c,2015,F,1,1,12,16,11,0,39,16,12,15,15,58,97
1368,Marshall Islands,Asia,c,2015,F,1,1,11,15,10,0,36,16,11,15,13,55,91
1369,Mauritania,SSA,c,2015,NF,6,5,3,2,4,0,9,10,4,4,4,22,31
1370,Mauritius,SSA,c,2015,F,1,2,12,15,11,0,38,15,12,13,12,52,90
1371,Mexico,Americas,c,2015,PF,3,3,9,12,7,0,28,12,8,6,10,36,64
1372,Micronesia,Asia,c,2015,F,1,1,12,15,10,0,37,16,11,15,14,56,93
1373,Moldova,Eurasia,c,2015,PF,3,3,10,12,6,0,28,11,8,7,9,35,63
1374,Monaco,Europe,c,2015,F,2,1,10,11,10,0,31,16,12,15,14,57,88
1375,Mongolia,Asia,c,2015,F,1,2,11,16,9,0,36,15,11,12,12,50,86
1376,Montenegro,Europe,c,2015,F,3,2,9,11,7,0,27,12,10,10,12,44,71
1377,Morocco,MENA,c,2015,PF,5,4,5,7,3,0,15,8,6,6,7,27,42
1378,Mozambique,SSA,c,2015,PF,4,3,6,10,7,0,23,12,7,7,9,35,58
1379,Myanmar,Asia,c,2015,NF,6,6,3,6,3,3,9,6,4,1,5,16,25
1380,Nagorno-Karabakh,Eurasia,t,2015,PF,5,5,4,5,3,0,12,6,3,4,5,18,30
1381,Namibia,SSA,c,2015,F,2,2,10,11,9,0,30,14,12,11,9,46,76
1382,Nauru,Asia,c,2015,F,1,2,12,16,9,0,37,14,11,12,14,51,88
1383,Nepal,Asia,c,2015,PF,3,4,8,11,5,0,24,9,6,5,7,27,51
1384,Netherlands,Europe,c,2015,F,1,1,12,16,12,0,40,16,12,15,16,59,99
1385,New Zealand,Asia,c,2015,F,1,1,12,15,12,0,39,16,12,15,15,58,97
1386,Nicaragua,Americas,c,2015,PF,4,3,6,7,6,0,19,12,6,7,10,35,54
1387,Niger,SSA,c,2015,PF,3,4,9,10,7,0,26,11,8,5,6,30,56
1388,Nigeria,SSA,c,2015,PF,4,5,6,9,4,1,18,9,7,4,5,25,43
1389,North Korea,Asia,c,2015,NF,7,7,0,0,0,0,0,0,0,0,3,3,3
1390,Northern Cyprus,Europe,t,2015,F,2,2,11,12,9,0,32,14,9,12,12,47,79
1391,Norway,Europe,c,2015,F,1,1,12,16,12,0,40,16,12,16,16,60,100
1392,Oman,MENA,c,2015,NF,6,5,2,2,2,0,9,5,3,4,5,17,26
1393,Pakistan,Asia,c,2015,PF,4,5,7,8,5,0,20,5,7,4,6,22,42
1394,Pakistani Kashmir,Asia,t,2015,NF,6,5,4,4,3,2,9,6,4,4,6,20,29
1395,Palau,Asia,c,2015,F,1,1,12,15,10,0,37,16,11,15,13,55,92
1396,Panama,Americas,c,2015,F,2,2,12,15,8,0,35,15,11,9,12,47,82
1397,Papua New Guinea,Asia,c,2015,PF,4,3,9,10,4,0,23,12,9,7,8,36,59
1398,Paraguay,Americas,c,2015,PF,3,3,10,12,5,0,27,12,8,7,11,38,65
1399,Peru,Americas,c,2015,F,2,3,10,13,7,0,30,15,8,8,10,41,71
1400,Philippines,Asia,c,2015,PF,3,3,9,10,7,0,26,14,8,5,10,37,63
1401,Poland,Europe,c,2015,F,1,1,12,16,10,0,38,16,12,13,14,55,93
1402,Portugal,Europe,c,2015,F,1,1,12,16,11,0,39,16,12,15,15,58,97
1403,Puerto Rico,Americas,t,2015,F,1,2,12,15,10,0,37,16,10,12,14,52,89
1404,Qatar,MENA,c,2015,NF,6,5,2,2,3,0,10,8,2,4,4,18,28
1405,Romania,Europe,c,2015,F,2,2,11,14,9,0,34,14,11,12,12,49,83
1406,Russia,Eurasia,c,2015,NF,6,6,1,3,3,0,7,4,4,2,6,16,23
1407,Rwanda,SSA,c,2015,NF,6,6,2,2,5,0,9,4,2,3,7,16,25
1408,Samoa,Asia,c,2015,F,2,2,9,13,10,0,32,14,10,13,12,49,81
1409,San Marino,Europe,c,2015,F,1,1,12,16,12,0,40,16,12,16,16,60,100
1410,Sao Tome and Principe,SSA,c,2015,F,2,2,11,14,9,0,34,15,10,12,10,47,81
1411,Saudi Arabia,MENA,c,2015,NF,7,7,0,0,1,0,3,3,0,2,2,7,10
1412,Senegal,SSA,c,2015,F,2,2,11,13,9,0,33,15,10,10,10,45,78
1413,Serbia,Europe,c,2015,F,2,2,10,14,7,0,31,15,11,10,13,49,80
1414,Seychelles,SSA,c,2015,PF,3,3,8,10,7,0,25,11,9,11,11,42,67
1415,Sierra Leone,SSA,c,2015,PF,3,3,10,11,7,0,28,12,7,9,9,37,65
1416,Singapore,Asia,c,2015,PF,4,4,4,8,7,0,19,9,4,7,12,32,51
1417,Slovakia,Europe,c,2015,F,1,1,12,15,10,0,37,15,12,12,14,53,90
1418,Slovenia,Europe,c,2015,F,1,1,12,15,11,0,38,14,12,14,13,53,91
1419,Solomon Islands,Asia,c,2015,PF,3,3,9,10,6,0,25,14,9,8,12,43,68
1420,Somalia,SSA,c,2015,NF,7,7,0,0,0,0,0,1,0,0,1,2,2
1421,Somaliland,SSA,t,2015,PF,4,5,5,10,6,0,21,7,5,7,6,25,46
1422,South Africa,SSA,c,2015,F,2,2,12,13,8,0,33,15,12,10,11,48,81
1423,South Korea,Asia,c,2015,F,2,2,11,13,10,0,34,13,11,13,13,50,84
1424,South Ossetia,Eurasia,t,2015,NF,7,6,2,2,0,3,1,4,1,1,3,9,10
1425,South Sudan,SSA,c,2015,NF,7,6,3,0,1,2,2,4,3,1,5,13,15
1426,Spain,Europe,c,2015,F,1,1,12,16,11,0,39,15,12,15,15,57,96
1427,Sri Lanka,Asia,c,2015,PF,5,5,6,7,4,1,16,6,6,5,8,25,41
1428,St. Kitts and Nevis,Americas,c,2015,F,1,1,12,16,9,0,37,15,12,13,13,53,90
1429,St. Lucia,Americas,c,2015,F,1,1,12,16,11,0,39,15,12,12,14,53,92
1430,St. Vincent and the Grenadines,Americas,c,2015,F,1,1,11,16,9,0,36,15,12,13,14,54,90
1431,Sudan,SSA,c,2015,NF,7,7,2,3,1,4,2,2,1,0,1,4,6
1432,Suriname,Americas,c,2015,F,2,2,12,13,8,0,33,15,11,8,10,44,77
1433,Swaziland,SSA,c,2015,NF,7,5,0,1,0,0,1,6,2,5,4,17,18
1434,Sweden,Europe,c,2015,F,1,1,12,16,12,0,40,15,12,16,16,59,99
1435,Switzerland,Europe,c,2015,F,1,1,12,15,12,0,39,15,12,15,15,57,96
1436,Syria,MENA,c,2015,NF,7,7,0,0,0,3,-3,2,0,0,0,2,-1
1437,Taiwan,Asia,c,2015,F,1,2,12,15,10,0,37,14,10,14,13,51,88
1438,Tajikistan,Eurasia,c,2015,NF,6,6,2,3,2,0,7,5,3,3,4,15,22
1439,Tanzania,SSA,c,2015,PF,3,3,9,12,7,0,28,10,7,9,9,35,63
1440,Thailand,Asia,c,2015,NF,6,5,1,4,3,0,8,6,4,5,10,25,33
1441,The Gambia,SSA,c,2015,NF,6,6,2,5,0,0,7,3,3,1,6,13,20
1442,Tibet,Asia,t,2015,NF,7,7,0,0,1,3,-2,0,0,0,3,3,1
1443,Timor-Leste,Asia,c,2015,PF,3,3,11,12,6,0,29,12,8,7,9,36,65
1444,Togo,SSA,c,2015,PF,4,4,5,8,5,0,18,9,6,7,7,29,47
1445,Tonga,Asia,c,2015,F,2,2,11,14,6,0,31,13,8,11,12,44,75
1446,Transnistria,Eurasia,t,2015,NF,6,6,3,5,2,0,10,5,2,2,5,14,24
1447,Trinidad and Tobago,Americas,c,2015,F,2,2,11,13,9,0,33,15,11,9,13,48,81
1448,Tunisia,MENA,c,2015,F,1,3,12,16,8,0,36,13,10,9,11,43,79
1449,Turkey,Europe,c,2015,PF,3,4,10,10,6,0,26,8,5,7,9,29,55
1450,Turkmenistan,Eurasia,c,2015,NF,7,7,0,1,0,0,1,2,0,0,3,5,6
1451,Tuvalu,Asia,c,2015,F,1,1,12,15,10,0,37,16,12,15,14,57,94
1452,Uganda,SSA,c,2015,NF,6,5,3,5,3,0,11,9,4,5,7,25,36
1453,Ukraine,Eurasia,c,2015,PF,3,3,9,10,6,0,25,11,9,6,11,37,62
1454,United Arab Emirates,MENA,c,2015,NF,6,6,1,2,2,0,8,4,2,3,4,13,21
1455,United Kingdom,Europe,c,2015,F,1,1,12,16,12,0,40,15,12,15,15,57,97
1456,United States,Americas,c,2015,F,1,1,11,16,10,0,37,15,11,14,15,55,92
1457,Uruguay,Americas,c,2015,F,1,1,12,16,12,0,40,16,12,15,15,58,98
1458,Uzbekistan,Eurasia,c,2015,NF,7,7,0,0,0,0,0,1,0,0,3,4,4
1459,Vanuatu,Asia,c,2015,F,2,2,9,15,8,0,32,15,11,10,11,47,79
1460,Venezuela,Americas,c,2015,PF,5,5,5,6,2,0,13,8,3,3,8,22,35
1461,Vietnam,Asia,c,2015,NF,7,5,0,1,2,0,3,4,1,4,8,17,20
1462,West Bank,MENA,t,2015,NF,6,5,2,5,2,3,6,9,6,5,5,25,31
1463,Western Sahara,MENA,t,2015,NF,7,7,0,0,0,2,-2,3,0,0,4,7,5
1464,Yemen,MENA,c,2015,NF,6,6,3,4,2,0,9,6,3,2,5,16,25
1465,Zambia,SSA,c,2015,PF,3,4,8,12,6,0,26,11,7,8,8,34,60
1466,Zimbabwe,SSA,c,2015,NF,5,6,3,6,3,0,12,6,3,2,5,16,28
1467,Abkhazia,Eurasia,t,2014,PF,4,5,7,7,4,0,18,8,5,4,5,22,40
1468,Afghanistan,Asia,c,2014,NF,6,6,3,6,2,0,11,6,4,2,3,15,26
1469,Albania,Europe,c,2014,PF,3,3,8,13,6,0,27,13,9,9,9,40,67
1470,Algeria,MENA,c,2014,NF,6,5,4,4,3,0,11,6,5,5,7,23,34
1471,Andorra,Europe,c,2014,F,1,1,12,15,12,0,39,16,11,15,15,57,96
1472,Angola,SSA,c,2014,NF,6,5,4,6,1,0,11,7,4,4,3,18,29
1473,Antigua and Barbuda,Americas,c,2014,F,2,2,11,13,7,0,31,14,9,13,13,49,80
1474,Argentina,Americas,c,2014,F,2,2,11,14,6,0,31,14,11,11,13,49,80
1475,Armenia,Eurasia,c,2014,PF,5,4,5,6,3,0,14,8,6,6,9,29,43
1476,Australia,Asia,c,2014,F,1,1,12,15,12,0,39,16,12,15,15,58,97
1477,Austria,Europe,c,2014,F,1,1,12,15,11,0,38,16,12,15,15,58,96
1478,Azerbaijan,Eurasia,c,2014,NF,6,6,1,3,2,0,6,4,2,4,6,16,22
1479,Bahamas,Americas,c,2014,F,1,1,12,16,10,0,38,16,12,15,15,58,96
1480,Bahrain,MENA,c,2014,NF,6,6,3,2,3,2,6,2,1,1,6,10,16
1481,Bangladesh,Asia,c,2014,PF,3,4,9,10,5,0,24,8,6,6,9,29,53
1482,Barbados,Americas,c,2014,F,1,1,12,16,12,0,40,16,12,16,15,59,99
1483,Belarus,Eurasia,c,2014,NF,7,6,0,3,1,0,4,3,1,1,5,10,14
1484,Belgium,Europe,c,2014,F,1,1,12,16,12,0,40,15,12,15,15,57,97
1485,Belize,Americas,c,2014,F,1,2,12,14,10,0,36,15,11,12,13,51,87
1486,Benin,SSA,c,2014,F,2,2,8,16,8,0,32,15,11,12,10,48,80
1487,Bhutan,Asia,c,2014,PF,3,4,10,10,9,1,28,9,4,6,8,27,55
1488,Bolivia,Americas,c,2014,PF,3,3,11,11,7,0,29,14,9,6,9,38,67
1489,Bosnia and Herzegovina,Europe,c,2014,PF,3,3,8,10,6,0,24,10,7,10,10,37,61
1490,Botswana,SSA,c,2014,F,3,2,10,10,8,0,28,13,10,12,11,46,74
1491,Brazil,Americas,c,2014,F,2,2,11,14,8,0,33,15,10,10,13,48,81
1492,Brunei,Asia,c,2014,NF,6,5,0,3,3,0,7,6,3,6,8,23,30
1493,Bulgaria,Europe,c,2014,F,2,2,10,14,7,0,31,14,11,11,11,47,78
1494,Burkina Faso,SSA,c,2014,PF,5,3,5,8,4,0,17,13,8,7,8,36,53
1495,Burundi,SSA,c,2014,PF,5,5,4,6,2,0,12,8,4,4,6,22,34
1496,Cambodia,Asia,c,2014,NF,6,5,3,4,3,0,10,9,3,2,6,20,30
1497,Cameroon,SSA,c,2014,NF,6,6,3,3,2,0,8,7,3,2,4,16,24
1498,Canada,Americas,c,2014,F,1,1,12,16,11,0,39,16,12,15,16,59,98
1499,Cape Verde,SSA,c,2014,F,1,1,12,15,10,0,37,15,11,14,13,53,90
1500,Central African Republic,SSA,c,2014,NF,7,7,0,1,0,1,0,4,1,0,1,6,6
1501,Chad,SSA,c,2014,NF,7,6,3,1,1,0,5,7,4,2,3,16,21
1502,Chile,Americas,c,2014,F,1,1,12,15,12,0,39,16,11,14,15,56,95
1503,China,Asia,c,2014,NF,7,6,0,1,2,1,2,4,3,2,6,15,17
1504,Colombia,Americas,c,2014,PF,3,4,10,11,7,0,28,12,5,7,10,34,62
1505,Comoros,SSA,c,2014,PF,3,4,9,11,5,0,25,10,6,8,6,30,55
1506,Congo (Brazzaville),SSA,c,2014,NF,6,5,1,3,3,0,7,8,6,2,7,23,30
1507,Congo (Kinshasa),SSA,c,2014,NF,6,6,3,4,2,0,9,7,3,0,1,11,20
1508,Costa Rica,Americas,c,2014,F,1,1,12,15,10,0,37,16,11,13,13,53,90
1509,Cote d'Ivoire,SSA,c,2014,PF,5,4,6,7,4,0,17,10,7,5,6,28,45
1510,Croatia,Europe,c,2014,F,1,2,12,15,9,0,36,14,12,11,13,50,86
1511,Cuba,Americas,c,2014,NF,7,6,0,0,1,0,1,3,0,2,6,11,12
1512,Cyprus,Europe,c,2014,F,1,1,11,16,10,0,37,15,11,15,14,55,92
1513,Czech Republic,Europe,c,2014,F,1,1,12,15,10,0,37,16,12,14,15,57,94
1514,Denmark,Europe,c,2014,F,1,1,12,16,12,0,40,16,12,15,15,58,98
1515,Djibouti,SSA,c,2014,NF,6,5,3,3,3,0,9,7,3,4,6,20,29
1516,Dominica,Americas,c,2014,F,1,1,12,16,10,0,38,15,12,15,15,57,95
1517,Dominican Republic,Americas,c,2014,F,2,3,10,11,9,0,30,15,10,8,10,43,73
1518,Ecuador,Americas,c,2014,PF,3,3,7,11,6,0,24,13,7,6,10,36,60
1519,Egypt,MENA,c,2014,NF,6,5,1,6,2,0,9,6,4,4,8,22,31
1520,El Salvador,Americas,c,2014,F,2,3,12,14,9,0,35,15,8,9,10,42,77
1521,Equatorial Guinea,SSA,c,2014,NF,7,7,0,1,0,0,1,4,0,0,3,7,8
1522,Eritrea,SSA,c,2014,NF,7,7,0,0,1,0,1,0,0,0,2,2,3
1523,Estonia,Europe,c,2014,F,1,1,12,15,12,0,39,16,12,14,14,56,95
1524,Ethiopia,SSA,c,2014,NF,6,6,1,2,4,0,7,3,0,3,5,11,18
1525,Fiji,Asia,c,2014,PF,6,4,0,5,2,0,7,11,3,6,10,30,37
1526,Finland,Europe,c,2014,F,1,1,12,16,12,0,40,16,12,16,16,60,100
1527,France,Europe,c,2014,F,1,1,12,15,11,0,38,15,12,15,15,57,95
1528,Gabon,SSA,c,2014,NF,6,5,2,4,3,0,9,10,4,6,5,25,34
1529,Gaza Strip,MENA,t,2014,NF,7,6,2,2,1,0,5,4,3,0,3,10,15
1530,Georgia,Eurasia,c,2014,PF,3,3,8,10,7,0,25,12,8,8,10,38,63
1531,Germany,Europe,c,2014,F,1,1,12,15,12,0,39,15,12,15,15,57,96
1532,Ghana,SSA,c,2014,F,1,2,12,15,10,0,37,14,11,12,10,47,84
1533,Greece,Europe,c,2014,F,2,2,12,15,8,0,35,14,11,10,13,48,83
1534,Grenada,Americas,c,2014,F,1,2,12,16,10,0,38,15,11,12,13,51,89
1535,Guatemala,Americas,c,2014,PF,3,4,9,10,5,0,24,12,6,6,8,32,56
1536,Guinea,SSA,c,2014,PF,5,5,6,8,3,0,17,9,6,4,5,24,41
1537,Guinea-Bissau,SSA,c,2014,NF,6,5,3,5,1,0,9,10,5,3,5,23,32
1538,Guyana,Americas,c,2014,F,2,3,11,13,7,0,31,15,10,7,9,41,72
1539,Haiti,Americas,c,2014,PF,4,5,4,9,5,0,18,10,5,4,6,25,43
1540,Honduras,Americas,c,2014,PF,4,4,7,9,4,0,20,11,6,5,9,31,51
1541,Hong Kong,Asia,t,2014,PF,5,2,3,7,6,0,16,14,9,15,13,51,67
1542,Hungary,Europe,c,2014,F,1,2,12,15,9,0,36,15,12,11,14,52,88
1543,Iceland,Europe,c,2014,F,1,1,12,16,12,0,40,16,12,16,16,60,100
1544,India,Asia,c,2014,F,2,3,11,14,9,0,34,13,11,9,10,43,77
1545,Indian Kashmir,Asia,t,2014,PF,4,4,8,8,4,0,20,9,6,6,8,29,49
1546,Indonesia,Asia,c,2014,PF,2,4,11,13,6,0,30,12,8,5,9,34,64
1547,Iran,MENA,c,2014,NF,6,6,3,2,2,0,7,2,1,3,4,10,17
1548,Iraq,MENA,c,2014,NF,5,6,7,5,1,1,12,5,4,0,4,13,25
1549,Ireland,Europe,c,2014,F,1,1,12,16,11,0,39,16,12,15,15,58,97
1550,Israel,MENA,c,2014,F,1,2,12,14,10,0,36,12,11,11,11,45,81
1551,Italy,Europe,c,2014,F,1,1,12,15,10,0,37,15,12,12,14,53,90
1552,Jamaica,Americas,c,2014,F,2,3,12,13,9,0,34,15,9,6,10,40,74
1553,Japan,Asia,c,2014,F,1,1,12,15,10,0,37,14,11,15,13,53,90
1554,Jordan,MENA,c,2014,NF,6,5,2,6,3,0,11,7,3,6,8,24,35
1555,Kazakhstan,Eurasia,c,2014,NF,6,5,2,3,1,0,6,4,3,4,8,19,25
1556,Kenya,SSA,c,2014,PF,4,4,7,10,5,0,22,11,7,6,7,31,53
1557,Kiribati,Asia,c,2014,F,1,1,12,16,8,0,36,15,12,15,13,55,91
1558,Kosovo,Europe,c,2014,PF,5,4,6,9,3,1,17,8,6,5,7,26,43
1559,Kuwait,MENA,c,2014,PF,5,5,2,9,5,0,16,6,4,7,6,23,39
1560,Kyrgyzstan,Eurasia,c,2014,PF,5,5,6,6,4,2,14,9,5,4,7,25,39
1561,Laos,Asia,c,2014,NF,7,6,0,0,1,0,1,4,0,2,5,11,12
1562,Latvia,Europe,c,2014,F,2,2,12,14,7,0,33,15,12,12,12,51,84
1563,Lebanon,MENA,c,2014,PF,5,4,4,9,3,0,16,11,7,5,9,32,48
1564,Lesotho,SSA,c,2014,F,2,3,10,13,8,0,31,14,7,11,9,41,72
1565,Liberia,SSA,c,2014,PF,3,4,9,11,6,0,26,10,8,7,8,33,59
1566,Libya,MENA,c,2014,PF,4,5,9,9,3,0,21,8,5,1,6,20,41
1567,Liechtenstein,Europe,c,2014,F,1,1,12,15,12,0,39,16,12,15,16,59,98
1568,Lithuania,Europe,c,2014,F,1,1,12,16,9,0,37,16,11,13,13,53,90
1569,Luxembourg,Europe,c,2014,F,1,1,12,16,11,0,39,16,12,16,16,60,99
1570,Macedonia,Europe,c,2014,PF,3,3,8,11,7,0,26,11,8,8,11,38,64
1571,Madagascar,SSA,c,2014,PF,5,4,6,8,1,0,15,9,7,5,7,28,43
1572,Malawi,SSA,c,2014,PF,3,4,8,11,7,0,26,11,7,9,7,34,60
1573,Malaysia,Asia,c,2014,PF,4,4,6,7,6,0,19,8,6,5,9,28,47
1574,Maldives,Asia,c,2014,PF,4,4,7,7,5,0,19,7,7,7,8,29,48
1575,Mali,SSA,c,2014,PF,5,4,6,7,4,0,17,11,6,6,4,27,44
1576,Malta,Europe,c,2014,F,1,1,12,16,11,0,39,16,12,15,15,58,97
1577,Marshall Islands,Asia,c,2014,F,1,1,11,15,10,0,36,16,11,15,13,55,91
1578,Mauritania,SSA,c,2014,NF,6,5,3,3,5,0,11,10,4,4,5,23,34
1579,Mauritius,SSA,c,2014,F,1,2,12,15,11,0,38,15,12,13,12,52,90
1580,Mexico,Americas,c,2014,PF,3,3,9,12,7,0,28,13,8,6,10,37,65
1581,Micronesia,Asia,c,2014,F,1,1,12,15,10,0,37,16,11,15,14,56,93
1582,Moldova,Eurasia,c,2014,PF,3,3,11,12,6,0,29,11,8,7,9,35,64
1583,Monaco,Europe,c,2014,F,2,1,10,11,10,0,31,16,12,15,14,57,88
1584,Mongolia,Asia,c,2014,F,1,2,11,16,9,0,36,15,11,12,12,50,86
1585,Montenegro,Europe,c,2014,F,3,2,9,11,7,0,27,13,10,10,12,45,72
1586,Morocco,MENA,c,2014,PF,5,4,5,7,3,0,15,8,6,6,7,27,42
1587,Mozambique,SSA,c,2014,PF,4,3,6,10,7,0,23,12,7,7,9,35,58
1588,Myanmar,Asia,c,2014,NF,6,5,3,6,3,3,9,7,4,1,5,17,26
1589,Nagorno-Karabakh,Eurasia,t,2014,PF,5,5,4,5,3,0,12,6,3,5,5,19,31
1590,Namibia,SSA,c,2014,F,2,2,10,11,9,0,30,14,12,11,9,46,76
1591,Nauru,Asia,c,2014,F,1,1,12,16,10,0,38,15,11,14,14,54,92
1592,Nepal,Asia,c,2014,PF,4,4,8,11,4,0,23,9,6,5,7,27,50
1593,Netherlands,Europe,c,2014,F,1,1,12,16,12,0,40,16,12,15,16,59,99
1594,New Zealand,Asia,c,2014,F,1,1,12,15,12,0,39,16,12,15,15,58,97
1595,Nicaragua,Americas,c,2014,PF,4,3,6,7,6,0,19,12,6,7,10,35,54
1596,Niger,SSA,c,2014,PF,3,4,9,10,7,0,26,11,8,5,6,30,56
1597,Nigeria,SSA,c,2014,PF,4,4,6,9,5,0,20,9,7,4,6,26,46
1598,North Korea,Asia,c,2014,NF,7,7,0,0,0,0,0,0,0,0,3,3,3
1599,Northern Cyprus,Europe,t,2014,F,2,2,11,12,9,0,32,14,9,12,12,47,79
1600,Norway,Europe,c,2014,F,1,1,12,16,12,0,40,16,12,16,16,60,100
1601,Oman,MENA,c,2014,NF,6,5,2,2,2,0,9,5,3,4,5,17,26
1602,Pakistan,Asia,c,2014,PF,4,5,7,9,5,0,21,5,6,4,6,21,42
1603,Pakistani Kashmir,Asia,t,2014,NF,6,5,3,4,3,2,8,6,5,4,6,21,29
1604,Palau,Asia,c,2014,F,1,1,12,15,10,0,37,16,11,15,13,55,92
1605,Panama,Americas,c,2014,F,2,2,12,15,8,0,35,15,11,9,12,47,82
1606,Papua New Guinea,Asia,c,2014,PF,3,3,9,10,5,0,24,12,9,7,8,36,60
1607,Paraguay,Americas,c,2014,PF,3,3,10,12,4,0,26,12,8,5,10,35,61
1608,Peru,Americas,c,2014,F,2,3,10,13,7,0,30,15,8,8,10,41,71
1609,Philippines,Asia,c,2014,PF,3,3,9,10,7,0,26,14,8,5,10,37,63
1610,Poland,Europe,c,2014,F,1,1,12,16,10,0,38,16,12,13,14,55,93
1611,Portugal,Europe,c,2014,F,1,1,12,16,11,0,39,16,12,15,15,58,97
1612,Puerto Rico,Americas,t,2014,F,1,2,12,15,10,0,37,16,10,12,14,52,89
1613,Qatar,MENA,c,2014,NF,6,5,2,2,3,0,10,8,2,4,4,18,28
1614,Romania,Europe,c,2014,F,2,2,12,14,9,0,35,14,11,12,12,49,84
1615,Russia,Eurasia,c,2014,NF,6,5,1,3,3,0,7,6,4,2,7,19,26
1616,Rwanda,SSA,c,2014,NF,6,5,2,2,5,0,9,5,2,3,7,17,26
1617,Samoa,Asia,c,2014,F,2,2,9,13,10,0,32,14,10,13,12,49,81
1618,San Marino,Europe,c,2014,F,1,1,12,16,12,0,40,16,12,16,16,60,100
1619,Sao Tome and Principe,SSA,c,2014,F,2,2,11,14,9,0,34,15,10,12,10,47,81
1620,Saudi Arabia,MENA,c,2014,NF,7,7,0,0,1,0,3,3,0,2,2,7,10
1621,Senegal,SSA,c,2014,F,2,2,11,13,9,0,33,15,11,10,10,46,79
1622,Serbia,Europe,c,2014,F,2,2,9,14,7,0,30,15,10,10,13,48,78
1623,Seychelles,SSA,c,2014,PF,3,3,8,10,7,0,25,11,9,11,11,42,67
1624,Sierra Leone,SSA,c,2014,PF,3,3,10,12,7,0,29,12,7,9,10,38,67
1625,Singapore,Asia,c,2014,PF,4,4,4,8,7,0,19,9,4,7,12,32,51
1626,Slovakia,Europe,c,2014,F,1,1,12,15,10,0,37,16,12,12,14,54,91
1627,Slovenia,Europe,c,2014,F,1,1,12,15,11,0,38,14,12,14,13,53,91
1628,Solomon Islands,Asia,c,2014,PF,4,3,6,10,6,0,22,14,9,8,12,43,65
1629,Somalia,SSA,c,2014,NF,7,7,0,0,0,0,0,1,0,0,1,2,2
1630,Somaliland,SSA,t,2014,PF,4,5,5,10,6,0,21,7,5,7,6,25,46
1631,South Africa,SSA,c,2014,F,2,2,12,13,8,0,33,15,12,10,11,48,81
1632,South Korea,Asia,c,2014,F,2,2,11,14,10,0,35,14,11,13,12,50,85
1633,South Ossetia,Eurasia,t,2014,NF,7,6,0,0,0,3,-3,4,0,1,3,8,5
1634,South Sudan,SSA,c,2014,NF,6,6,4,2,2,0,8,7,3,1,5,16,24
1635,Spain,Europe,c,2014,F,1,1,12,16,11,0,39,15,12,15,15,57,96
1636,Sri Lanka,Asia,c,2014,PF,5,4,6,6,4,0,16,7,6,5,8,26,42
1637,St. Kitts and Nevis,Americas,c,2014,F,1,1,12,16,9,0,37,15,12,13,13,53,90
1638,St. Lucia,Americas,c,2014,F,1,1,12,16,11,0,39,15,12,12,14,53,92
1639,St. Vincent and the Grenadines,Americas,c,2014,F,1,1,11,16,9,0,36,15,12,12,14,53,89
1640,Sudan,SSA,c,2014,NF,7,7,2,3,1,4,2,3,1,0,1,5,7
1641,Suriname,Americas,c,2014,F,2,2,12,13,8,0,33,15,11,8,10,44,77
1642,Swaziland,SSA,c,2014,NF,7,5,0,1,0,0,1,8,2,5,4,19,20
1643,Sweden,Europe,c,2014,F,1,1,12,16,12,0,40,16,12,15,16,59,99
1644,Switzerland,Europe,c,2014,F,1,1,12,15,12,0,39,15,12,15,15,57,96
1645,Syria,MENA,c,2014,NF,7,7,0,0,0,2,-2,1,0,0,2,3,1
1646,Taiwan,Asia,c,2014,F,1,2,11,15,10,0,36,14,11,14,13,52,88
1647,Tajikistan,Eurasia,c,2014,NF,6,6,2,4,2,0,8,5,4,3,4,16,24
1648,Tanzania,SSA,c,2014,PF,3,3,9,12,8,0,29,10,7,9,9,35,64
1649,Thailand,Asia,c,2014,PF,4,4,8,9,5,0,22,10,6,6,10,32,54
1650,The Gambia,SSA,c,2014,NF,6,6,2,5,0,0,7,4,3,1,6,14,21
1651,Tibet,Asia,t,2014,NF,7,7,0,0,1,3,-2,0,0,0,3,3,1
1652,Timor-Leste,Asia,c,2014,PF,3,4,11,12,6,0,29,12,7,6,9,34,63
1653,Togo,SSA,c,2014,PF,4,4,5,8,5,0,18,9,6,7,7,29,47
1654,Tonga,Asia,c,2014,F,2,2,11,14,6,0,31,13,8,11,12,44,75
1655,Transnistria,Eurasia,t,2014,NF,6,6,3,5,2,0,10,5,2,2,5,14,24
1656,Trinidad and Tobago,Americas,c,2014,F,2,2,11,13,9,0,33,15,11,9,13,48,81
1657,Tunisia,MENA,c,2014,PF,3,3,9,12,6,0,27,11,9,6,10,36,63
1658,Turkey,Europe,c,2014,PF,3,4,11,10,7,0,28,9,6,8,9,32,60
1659,Turkmenistan,Eurasia,c,2014,NF,7,7,0,1,0,0,1,2,0,1,3,6,7
1660,Tuvalu,Asia,c,2014,F,1,1,12,15,10,0,37,16,12,15,14,57,94
1661,Uganda,SSA,c,2014,PF,6,4,3,5,3,0,11,10,4,5,7,26,37
1662,Ukraine,Eurasia,c,2014,PF,4,3,8,8,4,0,20,9,8,7,11,35,55
1663,United Arab Emirates,MENA,c,2014,NF,6,6,1,2,2,0,8,4,2,3,4,13,21
1664,United Kingdom,Europe,c,2014,F,1,1,12,16,12,0,40,15,12,15,15,57,97
1665,United States,Americas,c,2014,F,1,1,11,16,10,0,37,15,11,14,15,55,92
1666,Uruguay,Americas,c,2014,F,1,1,12,16,12,0,40,16,12,15,15,58,98
1667,Uzbekistan,Eurasia,c,2014,NF,7,7,0,0,0,0,0,1,0,0,3,4,4
1668,Vanuatu,Asia,c,2014,F,2,2,9,15,8,0,32,15,11,10,11,47,79
1669,Venezuela,Americas,c,2014,PF,5,5,5,7,2,0,14,8,4,4,8,24,38
1670,Vietnam,Asia,c,2014,NF,7,5,0,1,2,0,3,4,1,4,8,17,20
1671,West Bank,MENA,t,2014,NF,6,5,2,5,2,2,7,8,6,5,5,24,31
1672,Western Sahara,MENA,t,2014,NF,7,7,0,0,0,2,-2,3,0,0,4,7,5
1673,Yemen,MENA,c,2014,NF,6,6,3,4,3,0,10,6,3,2,5,16,26
1674,Zambia,SSA,c,2014,PF,3,4,8,10,7,0,25,11,7,8,8,34,59
1675,Zimbabwe,SSA,c,2014,NF,5,6,3,6,3,0,12,6,3,2,5,16,28
1676,Abkhazia,Eurasia,t,2013,PF,4,5,7,7,4,0,18,8,5,4,5,22,40
1677,Afghanistan,Asia,c,2013,NF,6,6,3,6,2,0,11,6,5,2,3,16,27
1678,Albania,Europe,c,2013,PF,3,3,8,10,6,0,24,13,8,9,9,39,63
1679,Algeria,MENA,c,2013,NF,6,5,4,4,3,0,11,7,5,5,7,24,35
1680,Andorra,Europe,c,2013,F,1,1,12,15,12,0,39,16,11,15,15,57,96
1681,Angola,SSA,c,2013,NF,6,5,4,6,1,0,11,8,4,4,3,19,30
1682,Antigua and Barbuda,Americas,c,2013,F,2,2,11,13,7,0,31,14,9,13,13,49,80
1683,Argentina,Americas,c,2013,F,2,2,11,14,6,0,31,14,11,11,13,49,80
1684,Armenia,Eurasia,c,2013,PF,5,4,5,5,3,0,13,8,6,6,9,29,42
1685,Australia,Asia,c,2013,F,1,1,12,15,12,0,39,16,12,15,15,58,97
1686,Austria,Europe,c,2013,F,1,1,12,15,11,0,38,16,12,15,15,58,96
1687,Azerbaijan,Eurasia,c,2013,NF,6,5,1,3,2,0,6,4,2,4,7,17,23
1688,Bahamas,Americas,c,2013,F,1,1,12,16,10,0,38,16,12,15,15,58,96
1689,Bahrain,MENA,c,2013,NF,6,6,3,2,3,2,6,3,2,1,6,12,18
1690,Bangladesh,Asia,c,2013,PF,3,4,9,11,5,0,25,9,7,6,9,31,56
1691,Barbados,Americas,c,2013,F,1,1,12,16,12,0,40,16,12,16,15,59,99
1692,Belarus,Eurasia,c,2013,NF,7,6,0,3,1,0,4,3,1,1,5,10,14
1693,Belgium,Europe,c,2013,F,1,1,12,16,12,0,40,15,12,15,15,57,97
1694,Belize,Americas,c,2013,F,1,2,12,14,11,0,37,15,11,12,13,51,88
1695,Benin,SSA,c,2013,F,2,2,8,16,8,0,32,15,12,13,10,50,82
1696,Bhutan,Asia,c,2013,PF,4,5,8,8,7,1,22,8,3,5,8,24,46
1697,Bolivia,Americas,c,2013,PF,3,3,11,11,7,0,29,14,10,7,9,40,69
1698,Bosnia and Herzegovina,Europe,c,2013,PF,3,3,8,11,6,0,25,10,7,10,10,37,62
1699,Botswana,SSA,c,2013,F,3,2,10,10,8,0,28,13,10,12,11,46,74
1700,Brazil,Americas,c,2013,F,2,2,11,14,8,0,33,15,10,10,13,48,81
1701,Brunei,Asia,c,2013,NF,6,5,0,3,3,0,7,6,3,6,8,23,30
1702,Bulgaria,Europe,c,2013,F,2,2,11,15,8,0,34,14,11,11,11,47,81
1703,Burkina Faso,SSA,c,2013,PF,5,3,5,8,4,0,17,13,8,7,8,36,53
1704,Burundi,SSA,c,2013,PF,5,5,4,6,2,0,12,8,4,4,6,22,34
1705,Cambodia,Asia,c,2013,NF,6,5,3,3,3,0,9,9,3,2,6,20,29
1706,Cameroon,SSA,c,2013,NF,6,6,2,3,2,0,7,7,3,2,4,16,23
1707,Canada,Americas,c,2013,F,1,1,12,16,12,0,40,16,11,15,16,58,98
1708,Cape Verde,SSA,c,2013,F,1,1,12,15,10,0,37,15,11,14,13,53,90
1709,Central African Republic,SSA,c,2013,PF,5,5,7,7,2,0,16,8,4,3,4,19,35
1710,Chad,SSA,c,2013,NF,7,6,3,1,1,0,5,7,4,2,3,16,21
1711,Chile,Americas,c,2013,F,1,1,12,15,12,0,39,16,11,15,15,57,96
1712,China,Asia,c,2013,NF,7,6,0,1,2,1,2,4,3,2,6,15,17
1713,Colombia,Americas,c,2013,PF,3,4,10,10,7,0,27,12,5,7,10,34,61
1714,Comoros,SSA,c,2013,PF,3,4,9,11,5,0,25,10,6,8,6,30,55
1715,Congo (Brazzaville),SSA,c,2013,NF,6,5,1,3,3,0,7,8,6,2,6,22,29
1716,Congo (Kinshasa),SSA,c,2013,NF,6,6,3,4,2,0,9,7,3,0,1,11,20
1717,Costa Rica,Americas,c,2013,F,1,1,12,15,11,0,38,16,11,13,13,53,91
1718,Cote d'Ivoire,SSA,c,2013,PF,5,5,5,4,4,0,13,8,5,4,4,21,34
1719,Croatia,Europe,c,2013,F,1,2,12,15,9,0,36,14,12,11,13,50,86
1720,Cuba,Americas,c,2013,NF,7,6,0,0,1,0,1,2,0,2,6,10,11
1721,Cyprus,Europe,c,2013,F,1,1,11,16,11,0,38,15,11,15,14,55,93
1722,Czech Republic,Europe,c,2013,F,1,1,12,15,11,0,38,16,12,14,15,57,95
1723,Denmark,Europe,c,2013,F,1,1,12,16,12,0,40,16,12,15,15,58,98
1724,Djibouti,SSA,c,2013,NF,6,5,3,3,3,0,9,7,3,4,6,20,29
1725,Dominica,Americas,c,2013,F,1,1,12,16,10,0,38,15,12,15,15,57,95
1726,Dominican Republic,Americas,c,2013,F,2,2,10,12,9,0,31,15,10,8,11,44,75
1727,Ecuador,Americas,c,2013,PF,3,3,7,11,6,0,24,13,7,6,10,36,60
1728,Egypt,MENA,c,2013,PF,5,5,3,10,3,0,16,8,5,4,8,25,41
1729,El Salvador,Americas,c,2013,F,2,3,12,14,9,0,35,15,8,9,10,42,77
1730,Equatorial Guinea,SSA,c,2013,NF,7,7,0,1,0,0,1,4,0,0,3,7,8
1731,Eritrea,SSA,c,2013,NF,7,7,0,0,1,0,1,0,0,0,2,2,3
1732,Estonia,Europe,c,2013,F,1,1,12,15,12,0,39,16,12,14,14,56,95
1733,Ethiopia,SSA,c,2013,NF,6,6,1,2,4,0,7,3,0,3,5,11,18
1734,Fiji,Asia,c,2013,PF,6,4,0,5,2,0,7,11,3,6,10,30,37
1735,Finland,Europe,c,2013,F,1,1,12,16,12,0,40,16,12,16,16,60,100
1736,France,Europe,c,2013,F,1,1,12,15,11,0,38,15,12,15,15,57,95
1737,Gabon,SSA,c,2013,NF,6,5,2,4,3,0,9,10,4,6,5,25,34
1738,Gaza Strip,MENA,t,2013,NF,6,6,5,2,2,0,9,4,3,0,3,10,19
1739,Georgia,Eurasia,c,2013,PF,3,3,7,10,7,0,24,12,7,7,10,36,60
1740,Germany,Europe,c,2013,F,1,1,12,15,12,0,39,15,12,15,15,57,96
1741,Ghana,SSA,c,2013,F,1,2,12,15,10,0,37,14,11,12,10,47,84
1742,Greece,Europe,c,2013,F,2,2,12,15,8,0,35,14,11,10,13,48,83
1743,Grenada,Americas,c,2013,F,1,2,12,16,10,0,38,15,11,12,13,51,89
1744,Guatemala,Americas,c,2013,PF,3,4,9,10,5,0,24,12,7,6,8,33,57
1745,Guinea,SSA,c,2013,PF,5,5,5,8,2,0,15,9,6,4,5,24,39
1746,Guinea-Bissau,SSA,c,2013,NF,6,5,2,5,0,0,7,10,5,3,5,23,30
1747,Guyana,Americas,c,2013,F,2,3,11,13,7,0,31,15,9,7,9,40,71
1748,Haiti,Americas,c,2013,PF,4,5,5,9,5,0,19,10,5,4,5,24,43
1749,Honduras,Americas,c,2013,PF,4,4,6,8,4,0,18,11,6,7,9,33,51
1750,Hong Kong,Asia,t,2013,PF,5,2,3,7,6,0,16,14,9,15,13,51,67
1751,Hungary,Europe,c,2013,F,1,2,12,15,9,0,36,15,12,11,14,52,88
1752,Iceland,Europe,c,2013,F,1,1,12,16,12,0,40,16,12,16,16,60,100
1753,India,Asia,c,2013,F,2,3,11,14,9,0,34,13,11,8,10,42,76
1754,Indian Kashmir,Asia,t,2013,PF,4,4,8,8,4,0,20,9,6,6,8,29,49
1755,Indonesia,Asia,c,2013,F,2,3,11,13,6,0,30,12,9,5,9,35,65
1756,Iran,MENA,c,2013,NF,6,6,2,2,2,0,6,2,1,3,4,10,16
1757,Iraq,MENA,c,2013,NF,6,6,7,4,1,1,11,5,4,0,4,13,24
1758,Ireland,Europe,c,2013,F,1,1,12,16,11,0,39,16,12,15,15,58,97
1759,Israel,MENA,c,2013,F,1,2,12,14,10,0,36,12,11,11,11,45,81
1760,Italy,Europe,c,2013,F,2,1,11,15,9,0,35,15,12,12,14,53,88
1761,Jamaica,Americas,c,2013,F,2,3,12,13,8,0,33,15,9,6,10,40,73
1762,Japan,Asia,c,2013,F,1,2,12,15,10,0,37,13,10,15,13,51,88
1763,Jordan,MENA,c,2013,NF,6,5,2,5,3,0,10,7,3,6,8,24,34
1764,Kazakhstan,Eurasia,c,2013,NF,6,5,2,3,1,0,6,5,3,4,8,20,26
1765,Kenya,SSA,c,2013,PF,4,4,6,10,5,0,21,13,8,6,7,34,55
1766,Kiribati,Asia,c,2013,F,1,1,12,16,8,0,36,15,12,15,13,55,91
1767,Kosovo,Europe,c,2013,PF,5,4,6,8,3,1,16,8,6,5,7,26,42
1768,Kuwait,MENA,c,2013,PF,5,5,2,10,5,0,17,7,4,7,6,24,41
1769,Kyrgyzstan,Eurasia,c,2013,PF,5,5,6,6,4,2,14,9,5,4,7,25,39
1770,Laos,Asia,c,2013,NF,7,6,0,0,0,0,0,4,0,2,5,11,11
1771,Latvia,Europe,c,2013,F,2,2,12,14,7,0,33,15,12,12,12,51,84
1772,Lebanon,MENA,c,2013,PF,5,4,5,9,3,0,17,11,7,5,9,32,49
1773,Lesotho,SSA,c,2013,F,2,3,10,13,8,0,31,14,7,11,9,41,72
1774,Liberia,SSA,c,2013,PF,3,4,9,11,6,0,26,11,8,7,8,34,60
1775,Libya,MENA,c,2013,PF,4,5,9,10,3,0,22,8,6,1,6,21,43
1776,Liechtenstein,Europe,c,2013,F,1,1,12,15,12,0,39,16,12,15,16,59,98
1777,Lithuania,Europe,c,2013,F,1,1,12,16,9,0,37,16,11,13,13,53,90
1778,Luxembourg,Europe,c,2013,F,1,1,12,16,12,0,40,16,12,16,16,60,100
1779,Macedonia,Europe,c,2013,PF,3,3,8,11,7,0,26,11,8,8,11,38,64
1780,Madagascar,SSA,c,2013,PF,6,4,1,5,1,0,7,9,7,5,7,28,35
1781,Malawi,SSA,c,2013,PF,3,4,8,11,7,0,26,11,7,9,7,34,60
1782,Malaysia,Asia,c,2013,PF,4,4,6,8,6,0,20,9,5,5,9,28,48
1783,Maldives,Asia,c,2013,PF,5,4,7,6,4,0,17,7,7,7,8,29,46
1784,Mali,SSA,c,2013,NF,7,5,1,3,2,1,5,8,4,3,4,19,24
1785,Malta,Europe,c,2013,F,1,1,12,16,11,0,39,16,12,15,15,58,97
1786,Marshall Islands,Asia,c,2013,F,1,1,11,15,10,0,36,16,11,15,13,55,91
1787,Mauritania,SSA,c,2013,NF,6,5,3,3,5,0,11,10,4,4,5,23,34
1788,Mauritius,SSA,c,2013,F,1,2,12,15,11,0,38,15,12,13,12,52,90
1789,Mexico,Americas,c,2013,PF,3,3,9,12,7,0,28,13,8,6,10,37,65
1790,Micronesia,Asia,c,2013,F,1,1,12,15,10,0,37,16,11,15,14,56,93
1791,Moldova,Eurasia,c,2013,PF,3,3,11,12,6,0,29,11,8,8,9,36,65
1792,Monaco,Europe,c,2013,F,2,1,10,11,10,0,31,15,12,15,14,56,87
1793,Mongolia,Asia,c,2013,F,1,2,11,16,9,0,36,15,11,12,12,50,86
1794,Montenegro,Europe,c,2013,F,3,2,9,11,7,0,27,13,10,10,12,45,72
1795,Morocco,MENA,c,2013,PF,5,4,5,7,4,0,16,8,6,6,7,27,43
1796,Mozambique,SSA,c,2013,PF,4,3,6,10,7,0,23,12,7,8,9,36,59
1797,Myanmar,Asia,c,2013,NF,6,5,3,6,3,3,9,7,4,1,5,17,26
1798,Nagorno-Karabakh,Eurasia,t,2013,PF,5,5,4,5,3,0,12,6,3,5,5,19,31
1799,Namibia,SSA,c,2013,F,2,2,10,11,9,0,30,14,12,11,9,46,76
1800,Nauru,Asia,c,2013,F,1,1,12,16,10,0,38,15,11,15,14,55,93
1801,Nepal,Asia,c,2013,PF,4,4,5,11,4,0,20,9,6,5,7,27,47
1802,Netherlands,Europe,c,2013,F,1,1,12,16,12,0,40,16,12,15,16,59,99
1803,New Zealand,Asia,c,2013,F,1,1,12,15,12,0,39,16,12,15,15,58,97
1804,Nicaragua,Americas,c,2013,PF,5,4,6,7,4,0,17,12,6,7,9,34,51
1805,Niger,SSA,c,2013,PF,3,4,9,10,7,0,26,11,8,5,6,30,56
1806,Nigeria,SSA,c,2013,PF,4,4,6,9,5,0,20,9,7,4,6,26,46
1807,North Korea,Asia,c,2013,NF,7,7,0,0,0,0,0,0,0,0,3,3,3
1808,Northern Cyprus,Europe,t,2013,F,2,2,11,12,9,0,32,13,9,12,12,46,78
1809,Norway,Europe,c,2013,F,1,1,12,16,12,0,40,16,12,16,16,60,100
1810,Oman,MENA,c,2013,NF,6,5,2,2,2,0,9,5,3,4,5,17,26
1811,Pakistan,Asia,c,2013,PF,4,5,6,9,5,0,20,5,7,4,6,22,42
1812,Pakistani Kashmir,Asia,t,2013,NF,6,5,3,4,3,2,8,6,5,4,6,21,29
1813,Palau,Asia,c,2013,F,1,1,12,15,10,0,37,16,11,15,13,55,92
1814,Panama,Americas,c,2013,F,1,2,12,15,9,0,36,15,10,9,12,46,82
1815,Papua New Guinea,Asia,c,2013,PF,4,3,9,10,4,0,23,12,9,7,8,36,59
1816,Paraguay,Americas,c,2013,PF,3,3,10,12,5,0,27,11,8,6,10,35,62
1817,Peru,Americas,c,2013,F,2,3,10,13,7,0,30,15,8,8,10,41,71
1818,Philippines,Asia,c,2013,PF,3,3,9,10,7,0,26,14,8,5,10,37,63
1819,Poland,Europe,c,2013,F,1,1,12,16,10,0,38,16,12,13,14,55,93
1820,Portugal,Europe,c,2013,F,1,1,12,16,11,0,39,16,12,15,15,58,97
1821,Puerto Rico,Americas,t,2013,F,1,2,12,15,10,0,37,16,10,12,14,52,89
1822,Qatar,MENA,c,2013,NF,6,5,2,2,3,0,10,8,2,4,4,18,28
1823,Romania,Europe,c,2013,F,2,2,10,14,8,0,32,14,11,12,12,49,81
1824,Russia,Eurasia,c,2013,NF,6,5,1,3,3,0,7,6,4,3,7,20,27
1825,Rwanda,SSA,c,2013,NF,6,6,2,2,4,0,8,4,2,3,7,16,24
1826,Samoa,Asia,c,2013,F,2,2,9,13,10,0,32,14,10,13,12,49,81
1827,San Marino,Europe,c,2013,F,1,1,12,16,12,0,40,16,12,16,16,60,100
1828,Sao Tome and Principe,SSA,c,2013,F,2,2,11,14,9,0,34,15,10,12,10,47,81
1829,Saudi Arabia,MENA,c,2013,NF,7,7,0,0,1,0,3,3,0,2,2,7,10
1830,Senegal,SSA,c,2013,F,2,3,11,13,8,0,32,14,10,10,9,43,75
1831,Serbia,Europe,c,2013,F,2,2,9,14,7,0,30,15,10,10,13,48,78
1832,Seychelles,SSA,c,2013,PF,3,3,8,10,7,0,25,11,9,11,11,42,67
1833,Sierra Leone,SSA,c,2013,F,2,3,10,12,8,0,30,13,8,9,10,40,70
1834,Singapore,Asia,c,2013,PF,4,4,4,8,7,0,19,10,4,7,12,33,52
1835,Slovakia,Europe,c,2013,F,1,1,12,15,10,0,37,16,12,13,14,55,92
1836,Slovenia,Europe,c,2013,F,1,1,12,15,11,0,38,14,12,14,13,53,91
1837,Solomon Islands,Asia,c,2013,PF,4,3,6,10,6,0,22,14,9,8,12,43,65
1838,Somalia,SSA,c,2013,NF,7,7,0,0,0,0,0,1,0,0,1,2,2
1839,Somaliland,SSA,t,2013,PF,4,5,5,10,6,0,21,7,5,7,6,25,46
1840,South Africa,SSA,c,2013,F,2,2,12,14,8,0,34,15,11,10,11,47,81
1841,South Korea,Asia,c,2013,F,1,2,11,15,10,0,36,14,11,13,12,50,86
1842,South Ossetia,Eurasia,t,2013,NF,7,6,0,0,0,3,-3,4,0,1,3,8,5
1843,South Sudan,SSA,c,2013,NF,6,5,4,5,2,0,11,8,4,3,5,20,31
1844,Spain,Europe,c,2013,F,1,1,12,16,11,0,39,16,12,14,15,57,96
1845,Sri Lanka,Asia,c,2013,PF,5,4,6,6,4,0,16,8,6,5,8,27,43
1846,St. Kitts and Nevis,Americas,c,2013,F,1,1,12,16,10,0,38,15,12,12,14,53,91
1847,St. Lucia,Americas,c,2013,F,1,1,12,16,11,0,39,16,12,12,14,54,93
1848,St. Vincent and the Grenadines,Americas,c,2013,F,1,1,11,16,9,0,36,15,11,13,14,53,89
1849,Sudan,SSA,c,2013,NF,7,7,2,3,1,4,2,3,1,0,1,5,7
1850,Suriname,Americas,c,2013,F,2,2,12,13,8,0,33,15,11,8,10,44,77
1851,Swaziland,SSA,c,2013,NF,7,5,0,1,0,0,1,8,3,5,4,20,21
1852,Sweden,Europe,c,2013,F,1,1,12,16,12,0,40,16,12,16,16,60,100
1853,Switzerland,Europe,c,2013,F,1,1,12,15,12,0,39,15,12,15,15,57,96
1854,Syria,MENA,c,2013,NF,7,7,0,0,1,2,-1,2,0,0,4,6,5
1855,Taiwan,Asia,c,2013,F,1,2,11,15,10,0,36,14,11,14,13,52,88
1856,Tajikistan,Eurasia,c,2013,NF,6,6,2,4,2,0,8,5,4,3,4,16,24
1857,Tanzania,SSA,c,2013,PF,3,3,9,12,7,0,28,11,7,11,9,38,66
1858,Thailand,Asia,c,2013,PF,4,4,8,9,5,0,22,9,6,6,10,31,53
1859,The Gambia,SSA,c,2013,NF,6,6,2,5,0,0,7,5,4,1,6,16,23
1860,Tibet,Asia,t,2013,NF,7,7,0,0,1,3,-2,0,0,0,3,3,1
1861,Timor-Leste,Asia,c,2013,PF,3,4,11,12,6,0,29,12,7,6,9,34,63
1862,Togo,SSA,c,2013,PF,5,4,4,8,4,0,16,8,6,6,7,27,43
1863,Tonga,Asia,c,2013,F,3,2,11,14,4,0,29,13,8,11,12,44,73
1864,Transnistria,Eurasia,t,2013,NF,6,6,3,5,2,0,10,6,2,2,5,15,25
1865,Trinidad and Tobago,Americas,c,2013,F,2,2,11,13,9,0,33,15,11,9,13,48,81
1866,Tunisia,MENA,c,2013,PF,3,4,9,12,5,0,26,10,8,6,9,33,59
1867,Turkey,Europe,c,2013,PF,3,4,11,10,7,0,28,9,7,7,10,33,61
1868,Turkmenistan,Eurasia,c,2013,NF,7,7,0,1,0,0,1,2,0,1,3,6,7
1869,Tuvalu,Asia,c,2013,F,1,1,12,15,10,0,37,16,12,15,14,57,94
1870,Uganda,SSA,c,2013,PF,5,4,3,6,3,0,12,11,4,6,7,28,40
1871,Ukraine,Eurasia,c,2013,PF,4,3,8,9,4,0,21,10,8,7,11,36,57
1872,United Arab Emirates,MENA,c,2013,NF,6,6,1,2,2,0,8,4,2,4,4,14,22
1873,United Kingdom,Europe,c,2013,F,1,1,12,16,12,0,40,15,12,15,15,57,97
1874,United States,Americas,c,2013,F,1,1,11,16,10,0,37,16,11,14,15,56,93
1875,Uruguay,Americas,c,2013,F,1,1,12,16,11,0,39,16,12,15,15,58,97
1876,Uzbekistan,Eurasia,c,2013,NF,7,7,0,0,0,0,0,1,0,0,3,4,4
1877,Vanuatu,Asia,c,2013,F,2,2,9,15,8,0,32,15,11,10,11,47,79
1878,Venezuela,Americas,c,2013,PF,5,5,5,8,2,0,15,9,4,4,7,24,39
1879,Vietnam,Asia,c,2013,NF,7,5,0,1,1,0,2,4,1,4,8,17,19
1880,West Bank,MENA,t,2013,NF,6,5,2,5,2,3,6,8,6,5,5,24,30
1881,Western Sahara,MENA,t,2013,NF,7,7,0,0,0,2,-2,3,0,0,4,7,5
1882,Yemen,MENA,c,2013,NF,6,6,3,4,2,0,9,6,3,2,5,16,25
1883,Zambia,SSA,c,2013,PF,3,4,9,12,7,0,28,11,7,8,8,34,62
1884,Zimbabwe,SSA,c,2013,NF,6,6,3,5,3,0,11,6,3,1,4,14,25
1885,Abkhazia,Eurasia,t,2012,PF,5,5,6,7,4,0,17,8,5,4,5,22,39
1886,Afghanistan,Asia,c,2012,NF,6,6,3,6,1,0,10,5,4,1,3,13,23
1887,Albania,Europe,c,2012,PF,3,3,8,10,6,0,24,13,8,9,9,39,63
1888,Algeria,MENA,c,2012,NF,6,5,4,4,3,0,11,7,5,5,7,24,35
1889,Andorra,Europe,c,2012,F,1,1,12,15,12,0,39,16,11,15,15,57,96
1890,Angola,SSA,c,2012,NF,6,5,3,6,1,0,10,8,4,4,3,19,29
1891,Antigua and Barbuda,Americas,c,2012,F,3,2,11,12,6,0,29,13,9,13,13,48,77
1892,Argentina,Americas,c,2012,F,2,2,11,15,6,0,32,14,11,11,13,49,81
1893,Armenia,Eurasia,c,2012,PF,6,4,4,4,3,0,11,8,6,6,9,29,40
1894,Australia,Asia,c,2012,F,1,1,12,15,12,0,39,16,12,14,15,57,96
1895,Austria,Europe,c,2012,F,1,1,12,15,12,0,39,16,12,15,15,58,97
1896,Azerbaijan,Eurasia,c,2012,NF,6,5,1,3,2,0,6,4,2,4,7,17,23
1897,Bahamas,Americas,c,2012,F,1,1,12,16,10,0,38,16,12,15,15,58,96
1898,Bahrain,MENA,c,2012,NF,6,6,3,3,4,2,8,3,2,1,6,12,20
1899,Bangladesh,Asia,c,2012,PF,3,4,9,11,5,0,25,9,8,7,9,33,58
1900,Barbados,Americas,c,2012,F,1,1,12,16,12,0,40,16,12,16,15,59,99
1901,Belarus,Eurasia,c,2012,NF,7,6,0,3,1,0,4,3,1,1,5,10,14
1902,Belgium,Europe,c,2012,F,1,1,12,16,12,0,40,16,12,15,15,58,98
1903,Belize,Americas,c,2012,F,1,2,12,14,11,0,37,15,11,12,13,51,88
1904,Benin,SSA,c,2012,F,2,2,8,16,8,0,32,15,11,13,10,49,81
1905,Bhutan,Asia,c,2012,PF,4,5,7,7,6,1,19,8,3,5,8,24,43
1906,Bolivia,Americas,c,2012,PF,3,3,11,11,6,0,28,14,9,6,9,38,66
1907,Bosnia and Herzegovina,Europe,c,2012,PF,4,3,8,10,5,0,23,10,7,10,10,37,60
1908,Botswana,SSA,c,2012,F,3,2,10,11,8,0,29,13,10,12,11,46,75
1909,Brazil,Americas,c,2012,F,2,2,11,14,8,0,33,15,10,10,12,47,80
1910,Brunei,Asia,c,2012,NF,6,5,0,3,3,0,7,6,3,6,8,23,30
1911,Bulgaria,Europe,c,2012,F,2,2,11,15,8,0,34,14,11,11,11,47,81
1912,Burkina Faso,SSA,c,2012,PF,5,3,5,7,4,0,16,13,8,6,8,35,51
1913,Burundi,SSA,c,2012,PF,5,5,4,6,3,0,13,8,4,4,6,22,35
1914,Cambodia,Asia,c,2012,NF,6,5,3,3,3,0,9,9,4,2,6,21,30
1915,Cameroon,SSA,c,2012,NF,6,6,2,3,2,0,7,7,3,2,4,16,23
1916,Canada,Americas,c,2012,F,1,1,12,16,12,0,40,16,12,15,16,59,99
1917,Cape Verde,SSA,c,2012,F,1,1,12,15,10,0,37,15,11,14,13,53,90
1918,Central African Republic,SSA,c,2012,PF,5,5,7,7,3,0,17,10,5,3,4,22,39
1919,Chad,SSA,c,2012,NF,7,6,3,1,1,0,5,7,4,2,3,16,21
1920,Chile,Americas,c,2012,F,1,1,12,15,12,0,39,16,12,15,15,58,97
1921,China,Asia,c,2012,NF,7,6,0,1,2,1,2,3,3,2,6,14,16
1922,Colombia,Americas,c,2012,PF,3,4,10,10,7,0,27,12,5,7,10,34,61
1923,Comoros,SSA,c,2012,PF,3,4,9,11,5,0,25,10,6,8,6,30,55
1924,Congo (Brazzaville),SSA,c,2012,NF,6,5,1,3,3,0,7,8,6,2,6,22,29
1925,Congo (Kinshasa),SSA,c,2012,NF,6,6,3,4,2,0,9,7,3,0,1,11,20
1926,Costa Rica,Americas,c,2012,F,1,1,12,15,11,0,38,16,11,13,13,53,91
1927,Cote d'Ivoire,SSA,c,2012,NF,6,6,5,4,2,0,11,4,5,0,4,13,24
1928,Croatia,Europe,c,2012,F,1,2,12,15,9,0,36,14,12,11,13,50,86
1929,Cuba,Americas,c,2012,NF,7,6,0,0,1,0,1,3,1,2,4,10,11
1930,Cyprus,Europe,c,2012,F,1,1,11,16,11,0,38,15,11,15,14,55,93
1931,Czech Republic,Europe,c,2012,F,1,1,12,15,11,0,38,16,12,14,15,57,95
1932,Denmark,Europe,c,2012,F,1,1,12,16,12,0,40,16,12,15,15,58,98
1933,Djibouti,SSA,c,2012,NF,6,5,3,3,3,0,9,7,3,4,6,20,29
1934,Dominica,Americas,c,2012,F,1,1,12,16,10,0,38,16,12,15,15,58,96
1935,Dominican Republic,Americas,c,2012,F,2,2,10,12,9,0,31,15,10,8,11,44,75
1936,Ecuador,Americas,c,2012,PF,3,3,8,13,6,0,27,13,7,6,10,36,63
1937,Egypt,MENA,c,2012,NF,6,5,2,7,2,0,11,8,5,4,7,24,35
1938,El Salvador,Americas,c,2012,F,2,3,12,14,9,0,35,15,8,8,10,41,76
1939,Equatorial Guinea,SSA,c,2012,NF,7,7,0,1,0,0,1,4,0,0,3,7,8
1940,Eritrea,SSA,c,2012,NF,7,7,0,1,1,0,2,1,0,0,3,4,6
1941,Estonia,Europe,c,2012,F,1,1,12,15,12,0,39,16,12,14,14,56,95
1942,Ethiopia,SSA,c,2012,NF,6,6,1,2,4,0,7,4,0,3,5,12,19
1943,Fiji,Asia,c,2012,PF,6,4,0,5,2,0,7,10,2,6,10,28,35
1944,Finland,Europe,c,2012,F,1,1,12,16,12,0,40,16,12,16,16,60,100
1945,France,Europe,c,2012,F,1,1,12,15,11,0,38,15,12,15,15,57,95
1946,Gabon,SSA,c,2012,NF,6,5,2,4,3,0,9,10,4,6,5,25,34
1947,Gaza Strip,MENA,t,2012,NF,6,6,5,2,2,0,9,4,3,0,3,10,19
1948,Georgia,Eurasia,c,2012,PF,4,3,6,9,7,0,22,12,7,7,10,36,58
1949,Germany,Europe,c,2012,F,1,1,12,15,12,0,39,15,12,15,15,57,96
1950,Ghana,SSA,c,2012,F,1,2,12,15,10,0,37,14,11,12,10,47,84
1951,Greece,Europe,c,2012,F,2,2,12,15,8,0,35,14,12,11,13,50,85
1952,Grenada,Americas,c,2012,F,1,2,12,16,10,0,38,15,10,12,14,51,89
1953,Guatemala,Americas,c,2012,PF,3,4,9,10,5,0,24,12,8,6,8,34,58
1954,Guinea,SSA,c,2012,PF,5,5,5,8,1,0,14,7,5,4,4,20,34
1955,Guinea-Bissau,SSA,c,2012,PF,4,4,9,7,2,0,18,10,8,4,5,27,45
1956,Guyana,Americas,c,2012,F,2,3,11,13,7,0,31,15,10,7,9,41,72
1957,Haiti,Americas,c,2012,PF,4,5,5,10,5,0,20,10,6,4,5,25,45
1958,Honduras,Americas,c,2012,PF,4,4,6,8,5,0,19,11,6,7,9,33,52
1959,Hong Kong,Asia,t,2012,PF,5,2,3,7,6,0,16,14,9,15,13,51,67
1960,Hungary,Europe,c,2012,F,1,2,12,15,9,0,36,15,12,11,14,52,88
1961,Iceland,Europe,c,2012,F,1,1,12,16,12,0,40,16,12,16,15,59,99
1962,India,Asia,c,2012,F,2,3,11,14,9,0,34,13,11,9,10,43,77
1963,Indian Kashmir,Asia,t,2012,PF,4,4,8,8,4,0,20,9,6,5,8,28,48
1964,Indonesia,Asia,c,2012,F,2,3,11,13,6,0,30,12,9,5,9,35,65
1965,Iran,MENA,c,2012,NF,6,6,2,2,2,0,6,2,1,3,4,10,16
1966,Iraq,MENA,c,2012,NF,5,6,7,5,1,1,12,5,4,0,4,13,25
1967,Ireland,Europe,c,2012,F,1,1,12,16,11,0,39,16,12,15,15,58,97
1968,Israel,MENA,c,2012,F,1,2,12,14,10,0,36,12,11,11,11,45,81
1969,Italy,Europe,c,2012,F,1,1,11,15,10,0,36,15,12,12,14,53,89
1970,Jamaica,Americas,c,2012,F,2,3,12,13,8,0,33,15,9,6,10,40,73
1971,Japan,Asia,c,2012,F,1,2,12,15,10,0,37,13,10,15,13,51,88
1972,Jordan,MENA,c,2012,NF,6,5,2,5,3,0,10,7,4,6,8,25,35
1973,Kazakhstan,Eurasia,c,2012,NF,6,5,2,3,1,0,6,6,3,4,8,21,27
1974,Kenya,SSA,c,2012,PF,4,3,6,10,5,0,21,14,8,7,7,36,57
1975,Kiribati,Asia,c,2012,F,1,1,12,16,8,0,36,15,12,15,13,55,91
1976,Kosovo,Europe,c,2012,PF,5,4,6,7,3,1,15,8,6,5,7,26,41
1977,Kuwait,MENA,c,2012,PF,4,5,4,10,5,0,19,7,5,7,6,25,44
1978,Kyrgyzstan,Eurasia,c,2012,PF,5,5,6,7,5,2,16,9,5,4,7,25,41
1979,Laos,Asia,c,2012,NF,7,6,0,0,0,0,0,4,1,2,5,12,12
1980,Latvia,Europe,c,2012,F,2,2,12,14,7,0,33,15,12,12,12,51,84
1981,Lebanon,MENA,c,2012,PF,5,4,5,9,3,0,17,12,7,6,9,34,51
1982,Lesotho,SSA,c,2012,PF,3,3,9,11,8,0,28,14,7,11,9,41,69
1983,Liberia,SSA,c,2012,PF,3,4,9,11,6,0,26,11,8,7,8,34,60
1984,Libya,MENA,c,2012,NF,7,6,0,3,0,0,3,5,3,0,6,14,17
1985,Liechtenstein,Europe,c,2012,F,1,1,12,15,12,0,39,16,12,15,16,59,98
1986,Lithuania,Europe,c,2012,F,1,1,12,16,9,0,37,16,11,13,13,53,90
1987,Luxembourg,Europe,c,2012,F,1,1,12,16,12,0,40,16,12,16,16,60,100
1988,Macedonia,Europe,c,2012,PF,3,3,8,11,7,0,26,11,8,9,11,39,65
1989,Madagascar,SSA,c,2012,PF,6,4,1,5,1,0,7,10,7,6,9,32,39
1990,Malawi,SSA,c,2012,PF,3,4,7,11,7,0,25,10,6,9,7,32,57
1991,Malaysia,Asia,c,2012,PF,4,4,6,8,6,0,20,9,5,6,9,29,49
1992,Maldives,Asia,c,2012,PF,3,4,9,9,6,0,24,8,8,8,8,32,56
1993,Mali,SSA,c,2012,F,2,3,9,13,9,0,31,16,10,8,7,41,72
1994,Malta,Europe,c,2012,F,1,1,12,16,11,0,39,16,12,15,15,58,97
1995,Marshall Islands,Asia,c,2012,F,1,1,11,15,10,0,36,16,11,15,13,55,91
1996,Mauritania,SSA,c,2012,NF,6,5,3,3,5,0,11,9,4,4,5,22,33
1997,Mauritius,SSA,c,2012,F,1,2,12,15,11,0,38,15,12,13,12,52,90
1998,Mexico,Americas,c,2012,PF,3,3,10,12,7,0,29,13,8,6,10,37,66
1999,Micronesia,Asia,c,2012,F,1,1,12,15,10,0,37,16,11,15,14,56,93
2000,Moldova,Eurasia,c,2012,PF,3,3,11,12,5,0,28,12,8,8,9,37,65
2001,Monaco,Europe,c,2012,F,2,1,10,11,10,0,31,15,12,15,14,56,87
2002,Mongolia,Asia,c,2012,F,2,2,10,15,10,0,35,15,11,12,12,50,85
2003,Montenegro,Europe,c,2012,F,3,2,9,11,7,0,27,13,10,10,12,45,72
2004,Morocco,MENA,c,2012,PF,5,4,4,7,4,0,15,8,6,6,8,28,43
2005,Mozambique,SSA,c,2012,PF,4,3,6,10,7,0,23,12,7,8,9,36,59
2006,Myanmar,Asia,c,2012,NF,7,6,1,4,2,3,4,5,2,0,3,10,14
2007,Nagorno-Karabakh,Eurasia,t,2012,NF,6,5,4,3,3,0,10,6,3,5,5,19,29
2008,Namibia,SSA,c,2012,F,2,2,10,11,9,0,30,14,12,11,9,46,76
2009,Nauru,Asia,c,2012,F,1,1,12,16,10,0,38,15,11,15,14,55,93
2010,Nepal,Asia,c,2012,PF,4,4,6,11,4,0,21,9,6,5,7,27,48
2011,Netherlands,Europe,c,2012,F,1,1,12,16,12,0,40,16,12,15,16,59,99
2012,New Zealand,Asia,c,2012,F,1,1,12,15,12,0,39,16,12,15,15,58,97
2013,Nicaragua,Americas,c,2012,PF,5,4,6,7,4,0,17,12,6,7,9,34,51
2014,Niger,SSA,c,2012,PF,3,4,9,10,7,0,26,11,8,5,6,30,56
2015,Nigeria,SSA,c,2012,PF,4,4,6,9,6,0,21,9,8,4,7,28,49
2016,North Korea,Asia,c,2012,NF,7,7,0,0,0,0,0,0,0,0,2,2,2
2017,Northern Cyprus,Europe,t,2012,F,2,2,11,14,9,0,34,14,9,12,12,47,81
2018,Norway,Europe,c,2012,F,1,1,12,16,12,0,40,16,12,16,16,60,100
2019,Oman,MENA,c,2012,NF,6,5,2,2,2,0,9,6,3,4,5,18,27
2020,Pakistan,Asia,c,2012,PF,4,5,6,9,5,0,20,6,7,4,6,23,43
2021,Pakistani Kashmir,Asia,t,2012,NF,6,5,3,4,3,2,8,6,5,4,6,21,29
2022,Palau,Asia,c,2012,F,1,1,12,15,10,0,37,16,11,15,13,55,92
2023,Panama,Americas,c,2012,F,1,2,12,15,9,0,36,15,11,9,12,47,83
2024,Papua New Guinea,Asia,c,2012,PF,4,3,9,10,4,0,23,12,9,7,8,36,59
2025,Paraguay,Americas,c,2012,PF,3,3,11,12,5,0,28,12,8,6,10,36,64
2026,Peru,Americas,c,2012,F,2,3,10,13,7,0,30,15,8,8,10,41,71
2027,Philippines,Asia,c,2012,PF,3,3,9,10,7,0,26,14,8,4,10,36,62
2028,Poland,Europe,c,2012,F,1,1,12,16,10,0,38,16,12,13,14,55,93
2029,Portugal,Europe,c,2012,F,1,1,12,16,11,0,39,16,12,15,15,58,97
2030,Puerto Rico,Americas,t,2012,F,1,2,12,15,10,0,37,16,10,12,14,52,89
2031,Qatar,MENA,c,2012,NF,6,5,2,2,3,0,10,8,2,4,4,18,28
2032,Romania,Europe,c,2012,F,2,2,12,14,8,0,34,14,11,12,12,49,83
2033,Russia,Eurasia,c,2012,NF,6,5,1,3,3,0,7,6,5,3,7,21,28
2034,Rwanda,SSA,c,2012,NF,6,5,2,2,4,0,8,4,2,4,7,17,25
2035,Samoa,Asia,c,2012,F,2,2,9,13,10,0,32,14,10,13,12,49,81
2036,San Marino,Europe,c,2012,F,1,1,12,16,12,0,40,16,12,16,16,60,100
2037,Sao Tome and Principe,SSA,c,2012,F,2,2,11,14,8,0,33,15,10,12,10,47,80
2038,Saudi Arabia,MENA,c,2012,NF,7,7,0,0,1,0,3,3,0,2,2,7,10
2039,Senegal,SSA,c,2012,PF,3,3,9,12,7,0,28,14,10,10,9,43,71
2040,Serbia,Europe,c,2012,F,2,2,9,14,7,0,30,15,10,10,13,48,78
2041,Seychelles,SSA,c,2012,PF,3,3,8,10,7,0,25,11,9,11,11,42,67
2042,Sierra Leone,SSA,c,2012,PF,3,3,10,11,7,0,28,13,8,8,10,39,67
2043,Singapore,Asia,c,2012,PF,4,4,4,8,7,0,19,10,4,7,12,33,52
2044,Slovakia,Europe,c,2012,F,1,1,12,15,10,0,37,16,12,13,14,55,92
2045,Slovenia,Europe,c,2012,F,1,1,12,15,11,0,38,14,12,14,13,53,91
2046,Solomon Islands,Asia,c,2012,PF,4,3,6,10,6,0,22,13,9,8,12,42,64
2047,Somalia,SSA,c,2012,NF,7,7,0,0,0,0,0,1,0,0,0,1,1
2048,Somaliland,SSA,t,2012,PF,4,5,5,10,6,0,21,7,5,7,6,25,46
2049,South Africa,SSA,c,2012,F,2,2,12,14,8,0,34,15,12,10,11,48,82
2050,South Korea,Asia,c,2012,F,1,2,11,15,10,0,36,14,11,13,12,50,86
2051,South Ossetia,Eurasia,t,2012,NF,7,6,0,0,0,3,-3,4,0,1,3,8,5
2052,South Sudan,SSA,c,2012,NF,6,5,3,5,3,0,11,8,6,3,5,22,33
2053,Spain,Europe,c,2012,F,1,1,12,16,12,0,40,16,12,14,15,57,97
2054,Sri Lanka,Asia,c,2012,PF,5,4,6,6,5,0,17,8,6,6,8,28,45
2055,St. Kitts and Nevis,Americas,c,2012,F,1,1,12,16,11,0,39,15,12,12,14,53,92
2056,St. Lucia,Americas,c,2012,F,1,1,12,16,11,0,39,15,12,12,14,53,92
2057,St. Vincent and the Grenadines,Americas,c,2012,F,1,1,11,16,9,0,36,15,11,13,14,53,89
2058,Sudan,SSA,c,2012,NF,7,7,2,3,1,4,2,3,1,0,0,4,6
2059,Suriname,Americas,c,2012,F,2,2,12,13,8,0,33,15,11,9,10,45,78
2060,Swaziland,SSA,c,2012,NF,7,5,0,1,0,0,1,8,3,5,4,20,21
2061,Sweden,Europe,c,2012,F,1,1,12,16,12,0,40,16,12,16,16,60,100
2062,Switzerland,Europe,c,2012,F,1,1,12,15,12,0,39,15,12,15,15,57,96
2063,Syria,MENA,c,2012,NF,7,7,0,0,1,1,0,2,0,0,4,6,6
2064,Taiwan,Asia,c,2012,F,1,2,11,15,10,0,36,14,11,14,13,52,88
2065,Tajikistan,Eurasia,c,2012,NF,6,5,2,4,2,0,8,6,4,4,4,18,26
2066,Tanzania,SSA,c,2012,PF,3,3,9,12,7,0,28,11,7,10,8,36,64
2067,Thailand,Asia,c,2012,PF,4,4,8,8,5,0,21,9,6,6,10,31,52
2068,The Gambia,SSA,c,2012,NF,6,5,2,5,0,0,7,5,4,2,6,17,24
2069,Tibet,Asia,t,2012,NF,7,7,0,0,1,3,-2,0,0,0,3,3,1
2070,Timor-Leste,Asia,c,2012,PF,3,4,11,11,6,0,28,12,7,6,9,34,62
2071,Togo,SSA,c,2012,PF,5,4,5,8,4,0,17,8,6,6,7,27,44
2072,Tonga,Asia,c,2012,PF,3,3,11,14,4,0,29,12,7,11,12,42,71
2073,Transnistria,Eurasia,t,2012,NF,6,6,3,5,1,0,9,6,2,2,5,15,24
2074,Trinidad and Tobago,Americas,c,2012,F,2,2,11,13,9,0,33,15,11,9,13,48,81
2075,Tunisia,MENA,c,2012,PF,3,4,9,12,4,0,25,10,8,6,9,33,58
2076,Turkey,Europe,c,2012,PF,3,3,11,10,7,0,28,10,7,8,10,35,63
2077,Turkmenistan,Eurasia,c,2012,NF,7,7,0,1,0,0,1,2,0,1,3,6,7
2078,Tuvalu,Asia,c,2012,F,1,1,12,15,10,0,37,16,12,15,14,57,94
2079,Uganda,SSA,c,2012,PF,5,4,3,7,3,0,13,11,5,6,7,29,42
2080,Ukraine,Eurasia,c,2012,PF,4,3,9,10,4,0,23,10,8,8,11,37,60
2081,United Arab Emirates,MENA,c,2012,NF,6,6,1,2,2,0,8,6,2,4,4,16,24
2082,United Kingdom,Europe,c,2012,F,1,1,12,16,12,0,40,15,12,14,15,56,96
2083,United States,Americas,c,2012,F,1,1,11,16,11,0,38,16,10,14,15,55,93
2084,Uruguay,Americas,c,2012,F,1,1,12,16,11,0,39,16,12,15,15,58,97
2085,Uzbekistan,Eurasia,c,2012,NF,7,7,0,0,0,0,0,1,0,0,3,4,4
2086,Vanuatu,Asia,c,2012,F,2,2,9,15,8,0,32,16,11,10,11,48,80
2087,Venezuela,Americas,c,2012,PF,5,5,6,8,3,0,17,9,4,4,7,24,41
2088,Vietnam,Asia,c,2012,NF,7,5,0,1,1,0,2,4,1,4,8,17,19
2089,West Bank,MENA,t,2012,NF,6,5,2,5,2,2,7,8,6,5,5,24,31
2090,Western Sahara,MENA,t,2012,NF,7,7,0,0,0,2,-2,3,0,0,4,7,5
2091,Yemen,MENA,c,2012,NF,6,6,3,4,1,0,8,6,2,2,5,15,23
2092,Zambia,SSA,c,2012,PF,3,4,9,13,7,0,29,11,7,8,8,34,63
2093,Zimbabwe,SSA,c,2012,NF,6,6,2,4,2,0,8,4,3,1,4,12,20
2094,Abkhazia,Eurasia,t,2011,PF,5,5,5,6,4,0,15,8,5,4,5,22,37
2095,Afghanistan,Asia,c,2011,NF,6,6,3,6,1,0,10,5,4,2,4,15,25
2096,Albania,Europe,c,2011,PF,3,3,8,11,7,0,26,13,9,9,9,40,66
2097,Algeria,MENA,c,2011,NF,6,5,4,4,3,0,11,7,6,5,7,25,36
2098,Andorra,Europe,c,2011,F,1,1,12,15,12,0,39,16,11,15,15,57,96
2099,Angola,SSA,c,2011,NF,6,5,3,6,1,0,10,8,6,4,3,21,31
2100,Antigua and Barbuda,Americas,c,2011,F,3,2,11,12,6,0,29,13,9,13,13,48,77
2101,Argentina,Americas,c,2011,F,2,2,11,15,6,0,32,14,11,10,13,48,80
2102,Armenia,Eurasia,c,2011,PF,6,4,4,4,3,0,11,8,5,6,9,28,39
2103,Australia,Asia,c,2011,F,1,1,12,15,12,0,39,16,12,14,15,57,96
2104,Austria,Europe,c,2011,F,1,1,12,15,12,0,39,16,12,15,15,58,97
2105,Azerbaijan,Eurasia,c,2011,NF,6,5,1,3,3,0,7,6,3,4,8,21,28
2106,Bahamas,Americas,c,2011,F,1,1,12,16,10,0,38,16,12,15,15,58,96
2107,Bahrain,MENA,c,2011,NF,6,5,3,6,4,2,11,8,3,1,7,19,30
2108,Bangladesh,Asia,c,2011,PF,3,4,9,11,6,0,26,9,9,7,9,34,60
2109,Barbados,Americas,c,2011,F,1,1,12,16,12,0,40,16,12,16,15,59,99
2110,Belarus,Eurasia,c,2011,NF,7,6,0,3,1,0,4,3,1,2,5,11,15
2111,Belgium,Europe,c,2011,F,1,1,12,16,11,0,39,16,12,15,15,58,97
2112,Belize,Americas,c,2011,F,1,2,12,14,11,0,37,15,11,12,13,51,88
2113,Benin,SSA,c,2011,F,2,2,9,16,8,0,33,15,12,13,10,50,83
2114,Bhutan,Asia,c,2011,PF,4,5,7,7,6,1,19,8,3,5,8,24,43
2115,Bolivia,Americas,c,2011,PF,3,3,11,11,5,0,27,14,10,6,9,39,66
2116,Bosnia and Herzegovina,Europe,c,2011,PF,4,3,8,10,5,0,23,10,7,10,10,37,60
2117,Botswana,SSA,c,2011,F,3,2,10,11,8,0,29,13,10,12,11,46,75
2118,Brazil,Americas,c,2011,F,2,2,11,14,7,0,32,15,10,9,12,46,78
2119,Brunei,Asia,c,2011,NF,6,5,0,3,3,0,7,6,3,6,8,23,30
2120,Bulgaria,Europe,c,2011,F,2,2,12,15,8,0,35,14,11,11,11,47,82
2121,Burkina Faso,SSA,c,2011,PF,5,3,5,8,4,0,17,13,8,7,8,36,53
2122,Burundi,SSA,c,2011,PF,5,5,4,6,3,0,13,8,4,4,6,22,35
2123,Cambodia,Asia,c,2011,NF,6,5,3,3,3,0,9,9,4,1,6,20,29
2124,Cameroon,SSA,c,2011,NF,6,6,2,3,2,0,7,7,3,2,4,16,23
2125,Canada,Americas,c,2011,F,1,1,12,16,12,0,40,16,12,15,16,59,99
2126,Cape Verde,SSA,c,2011,F,1,1,12,15,10,0,37,15,11,14,13,53,90
2127,Central African Republic,SSA,c,2011,PF,5,5,5,7,3,0,15,10,5,3,4,22,37
2128,Chad,SSA,c,2011,NF,7,6,3,1,1,0,5,7,4,2,3,16,21
2129,Chile,Americas,c,2011,F,1,1,12,15,12,0,39,16,12,15,15,58,97
2130,China,Asia,c,2011,NF,7,6,0,1,2,1,2,4,3,2,6,15,17
2131,Colombia,Americas,c,2011,PF,3,4,10,10,7,0,27,12,5,7,10,34,61
2132,Comoros,SSA,c,2011,PF,3,4,9,11,5,0,25,10,6,8,6,30,55
2133,Congo (Brazzaville),SSA,c,2011,NF,6,5,1,3,3,0,7,8,6,2,6,22,29
2134,Congo (Kinshasa),SSA,c,2011,NF,6,6,6,3,2,0,11,6,3,0,1,10,21
2135,Costa Rica,Americas,c,2011,F,1,1,12,15,11,0,38,16,11,13,13,53,91
2136,Cote d'Ivoire,SSA,c,2011,NF,7,6,2,1,1,0,4,5,4,3,4,16,20
2137,Croatia,Europe,c,2011,F,1,2,12,15,9,0,36,14,12,11,13,50,86
2138,Cuba,Americas,c,2011,NF,7,6,0,0,1,0,1,3,1,2,3,9,10
2139,Cyprus,Europe,c,2011,F,1,1,11,16,11,0,38,15,12,15,14,56,94
2140,Czech Republic,Europe,c,2011,F,1,1,12,15,11,0,38,16,12,14,15,57,95
2141,Denmark,Europe,c,2011,F,1,1,12,16,12,0,40,16,12,14,15,57,97
2142,Djibouti,SSA,c,2011,NF,6,5,4,3,3,0,10,7,5,5,6,23,33
2143,Dominica,Americas,c,2011,F,1,1,12,16,10,0,38,16,12,15,15,58,96
2144,Dominican Republic,Americas,c,2011,F,2,2,10,12,9,0,31,15,11,8,11,45,76
2145,Ecuador,Americas,c,2011,PF,3,3,9,14,5,0,28,14,9,6,10,39,67
2146,Egypt,MENA,c,2011,NF,6,5,1,3,2,0,6,6,2,4,7,19,25
2147,El Salvador,Americas,c,2011,F,2,3,12,14,8,0,34,15,8,8,10,41,75
2148,Equatorial Guinea,SSA,c,2011,NF,7,7,0,1,0,0,1,4,0,0,3,7,8
2149,Eritrea,SSA,c,2011,NF,7,7,0,1,1,0,2,1,0,0,4,5,7
2150,Estonia,Europe,c,2011,F,1,1,12,15,12,0,39,16,12,14,14,56,95
2151,Ethiopia,SSA,c,2011,NF,6,6,1,3,4,0,8,4,0,4,5,13,21
2152,Fiji,Asia,c,2011,PF,6,4,0,5,2,0,7,10,4,6,10,30,37
2153,Finland,Europe,c,2011,F,1,1,12,16,12,0,40,16,12,16,16,60,100
2154,France,Europe,c,2011,F,1,1,12,15,11,0,38,16,12,14,15,57,95
2155,Gabon,SSA,c,2011,NF,6,5,2,4,3,0,9,10,4,6,5,25,34
2156,Gaza Strip,MENA,t,2011,NF,6,6,5,2,2,0,9,4,3,0,2,9,18
2157,Georgia,Eurasia,c,2011,PF,4,3,6,8,6,0,20,12,7,7,10,36,56
2158,Germany,Europe,c,2011,F,1,1,12,15,12,0,39,15,12,15,15,57,96
2159,Ghana,SSA,c,2011,F,1,2,12,15,10,0,37,14,11,12,10,47,84
2160,Greece,Europe,c,2011,F,1,2,12,15,9,0,36,14,12,11,13,50,86
2161,Grenada,Americas,c,2011,F,1,2,12,16,10,0,38,15,10,12,14,51,89
2162,Guatemala,Americas,c,2011,PF,4,4,9,10,4,0,23,12,8,6,8,34,57
2163,Guinea,SSA,c,2011,PF,5,5,5,8,1,0,14,8,6,4,4,22,36
2164,Guinea-Bissau,SSA,c,2011,PF,4,4,9,7,2,0,18,10,8,4,5,27,45
2165,Guyana,Americas,c,2011,F,2,3,11,13,7,0,31,15,10,7,9,41,72
2166,Haiti,Americas,c,2011,PF,4,5,5,10,5,0,20,10,6,4,5,25,45
2167,Honduras,Americas,c,2011,PF,4,4,6,8,5,0,19,11,6,7,9,33,52
2168,Hong Kong,Asia,t,2011,PF,5,2,3,7,6,0,16,14,9,15,13,51,67
2169,Hungary,Europe,c,2011,F,1,1,12,15,10,0,37,15,12,12,14,53,90
2170,Iceland,Europe,c,2011,F,1,1,12,16,12,0,40,16,12,16,15,59,99
2171,India,Asia,c,2011,F,2,3,11,14,9,0,34,13,10,9,10,42,76
2172,Indian Kashmir,Asia,t,2011,PF,4,5,8,8,4,0,20,8,5,4,8,25,45
2173,Indonesia,Asia,c,2011,F,2,3,11,13,6,0,30,11,10,5,9,35,65
2174,Iran,MENA,c,2011,NF,6,6,2,2,2,0,6,2,2,3,4,11,17
2175,Iraq,MENA,c,2011,NF,5,6,7,5,1,1,12,5,4,0,4,13,25
2176,Ireland,Europe,c,2011,F,1,1,12,16,11,0,39,16,12,15,15,58,97
2177,Israel,MENA,c,2011,F,1,2,12,14,10,0,36,13,12,11,11,47,83
2178,Italy,Europe,c,2011,F,1,2,12,15,10,0,37,14,12,12,14,52,89
2179,Jamaica,Americas,c,2011,F,2,3,12,13,8,0,33,15,9,6,10,40,73
2180,Japan,Asia,c,2011,F,1,2,12,15,10,0,37,13,10,15,13,51,88
2181,Jordan,MENA,c,2011,NF,6,5,2,5,3,0,10,7,3,6,8,24,34
2182,Kazakhstan,Eurasia,c,2011,NF,6,5,2,3,1,0,6,7,3,4,8,22,28
2183,Kenya,SSA,c,2011,PF,4,3,6,10,5,0,21,14,8,7,6,35,56
2184,Kiribati,Asia,c,2011,F,1,1,12,16,8,0,36,15,12,15,13,55,91
2185,Kosovo,Europe,c,2011,PF,5,4,6,7,3,1,15,8,6,5,7,26,41
2186,Kuwait,MENA,c,2011,PF,4,5,4,9,6,0,19,7,5,7,6,25,44
2187,Kyrgyzstan,Eurasia,c,2011,PF,5,5,6,6,3,2,13,8,5,4,7,24,37
2188,Laos,Asia,c,2011,NF,7,6,0,0,0,0,0,4,1,2,5,12,12
2189,Latvia,Europe,c,2011,F,2,2,12,14,7,0,33,15,12,12,13,52,85
2190,Lebanon,MENA,c,2011,PF,5,3,5,9,3,0,17,12,8,6,9,35,52
2191,Lesotho,SSA,c,2011,PF,3,3,9,11,9,0,29,14,7,11,9,41,70
2192,Liberia,SSA,c,2011,PF,3,4,8,10,6,0,24,11,8,7,8,34,58
2193,Libya,MENA,c,2011,NF,7,7,0,1,0,0,1,1,0,0,6,7,8
2194,Liechtenstein,Europe,c,2011,F,1,1,12,16,12,0,40,16,12,16,16,60,100
2195,Lithuania,Europe,c,2011,F,1,1,12,16,9,0,37,16,11,13,13,53,90
2196,Luxembourg,Europe,c,2011,F,1,1,12,16,12,0,40,16,12,16,16,60,100
2197,Macedonia,Europe,c,2011,PF,3,3,8,11,7,0,26,12,8,9,11,40,66
2198,Madagascar,SSA,c,2011,PF,6,4,1,5,1,0,7,10,7,6,9,32,39
2199,Malawi,SSA,c,2011,PF,3,4,8,11,7,0,26,11,7,9,7,34,60
2200,Malaysia,Asia,c,2011,PF,4,4,6,8,6,0,20,9,6,6,8,29,49
2201,Maldives,Asia,c,2011,PF,3,4,9,9,6,0,24,8,8,8,8,32,56
2202,Mali,SSA,c,2011,F,2,3,9,13,9,0,31,16,10,8,7,41,72
2203,Malta,Europe,c,2011,F,1,1,12,16,11,0,39,16,12,15,15,58,97
2204,Marshall Islands,Asia,c,2011,F,1,1,11,15,10,0,36,16,11,15,13,55,91
2205,Mauritania,SSA,c,2011,NF,6,5,3,3,5,0,11,9,5,4,5,23,34
2206,Mauritius,SSA,c,2011,F,1,2,12,15,11,0,38,15,12,13,12,52,90
2207,Mexico,Americas,c,2011,PF,3,3,10,12,7,0,29,13,8,6,10,37,66
2208,Micronesia,Asia,c,2011,F,1,1,12,15,10,0,37,16,11,15,14,56,93
2209,Moldova,Eurasia,c,2011,PF,3,3,10,12,5,0,27,11,8,8,9,36,63
2210,Monaco,Europe,c,2011,F,2,1,10,11,10,0,31,15,12,15,14,56,87
2211,Mongolia,Asia,c,2011,F,2,2,10,15,10,0,35,15,11,12,12,50,85
2212,Montenegro,Europe,c,2011,F,3,2,9,11,7,0,27,13,10,10,12,45,72
2213,Morocco,MENA,c,2011,PF,5,4,4,6,4,0,14,8,6,6,8,28,42
2214,Mozambique,SSA,c,2011,PF,4,3,6,10,7,0,23,12,7,8,9,36,59
2215,Myanmar,Asia,c,2011,NF,7,7,0,3,0,3,0,2,0,0,3,5,5
2216,Nagorno-Karabakh,Eurasia,t,2011,NF,6,5,4,3,3,0,10,6,3,5,5,19,29
2217,Namibia,SSA,c,2011,F,2,2,10,11,9,0,30,14,12,10,9,45,75
2218,Nauru,Asia,c,2011,F,1,1,12,16,10,0,38,15,11,15,14,55,93
2219,Nepal,Asia,c,2011,PF,4,4,6,11,3,0,20,9,6,6,7,28,48
2220,Netherlands,Europe,c,2011,F,1,1,12,16,12,0,40,16,12,14,16,58,98
2221,New Zealand,Asia,c,2011,F,1,1,12,15,12,0,39,16,12,15,15,58,97
2222,Nicaragua,Americas,c,2011,PF,4,4,9,7,4,0,20,12,6,7,9,34,54
2223,Niger,SSA,c,2011,PF,5,4,2,6,4,0,12,11,8,5,6,30,42
2224,Nigeria,SSA,c,2011,PF,4,4,4,9,6,0,19,9,8,5,7,29,48
2225,North Korea,Asia,c,2011,NF,7,7,0,0,0,0,0,0,0,0,1,1,1
2226,Northern Cyprus,Europe,t,2011,F,2,2,11,14,9,0,34,14,9,12,12,47,81
2227,Norway,Europe,c,2011,F,1,1,12,16,12,0,40,16,12,16,16,60,100
2228,Oman,MENA,c,2011,NF,6,5,2,2,2,0,9,6,3,4,5,18,27
2229,Pakistan,Asia,c,2011,PF,4,5,6,9,5,0,20,7,7,4,6,24,44
2230,Pakistani Kashmir,Asia,t,2011,NF,6,5,3,4,3,2,8,6,5,4,6,21,29
2231,Palau,Asia,c,2011,F,1,1,12,15,10,0,37,16,11,15,13,55,92
2232,Panama,Americas,c,2011,F,1,2,12,15,9,0,36,15,11,9,12,47,83
2233,Papua New Guinea,Asia,c,2011,PF,4,3,9,10,4,0,23,12,9,7,8,36,59
2234,Paraguay,Americas,c,2011,PF,3,3,11,12,5,0,28,12,8,6,10,36,64
2235,Peru,Americas,c,2011,F,2,3,11,13,7,0,31,15,8,8,10,41,72
2236,Philippines,Asia,c,2011,PF,3,3,9,10,6,0,25,14,8,4,10,36,61
2237,Poland,Europe,c,2011,F,1,1,12,16,10,0,38,16,12,13,14,55,93
2238,Portugal,Europe,c,2011,F,1,1,12,16,11,0,39,16,12,15,15,58,97
2239,Puerto Rico,Americas,t,2011,F,1,1,12,15,10,0,37,16,10,13,14,53,90
2240,Qatar,MENA,c,2011,NF,6,5,2,2,3,0,10,8,2,4,4,18,28
2241,Romania,Europe,c,2011,F,2,2,12,14,8,0,34,14,11,12,12,49,83
2242,Russia,Eurasia,c,2011,NF,6,5,1,3,3,0,7,6,4,3,7,20,27
2243,Rwanda,SSA,c,2011,NF,6,5,2,2,4,0,8,4,3,5,7,19,27
2244,Samoa,Asia,c,2011,F,2,2,9,13,10,0,32,14,10,13,12,49,81
2245,San Marino,Europe,c,2011,F,1,1,12,16,12,0,40,16,12,16,16,60,100
2246,Sao Tome and Principe,SSA,c,2011,F,2,2,11,14,8,0,33,15,10,12,10,47,80
2247,Saudi Arabia,MENA,c,2011,NF,7,6,0,0,1,0,3,4,0,3,2,9,12
2248,Senegal,SSA,c,2011,PF,3,3,9,12,7,0,28,14,10,10,9,43,71
2249,Serbia,Europe,c,2011,F,2,2,9,14,7,0,30,15,11,9,13,48,78
2250,Seychelles,SSA,c,2011,PF,3,3,8,10,7,0,25,11,9,11,11,42,67
2251,Sierra Leone,SSA,c,2011,PF,3,3,10,11,6,0,27,12,8,8,9,37,64
2252,Singapore,Asia,c,2011,PF,5,4,4,6,7,0,17,9,3,7,12,31,48
2253,Slovakia,Europe,c,2011,F,1,1,12,15,10,0,37,15,12,12,14,53,90
2254,Slovenia,Europe,c,2011,F,1,1,12,15,11,0,38,14,12,14,13,53,91
2255,Solomon Islands,Asia,c,2011,PF,4,3,6,10,6,0,22,13,9,8,12,42,64
2256,Somalia,SSA,c,2011,NF,7,7,0,0,0,0,0,1,0,0,0,1,1
2257,Somaliland,SSA,t,2011,PF,4,5,5,10,5,0,20,7,5,7,6,25,45
2258,South Africa,SSA,c,2011,F,2,2,12,14,9,0,35,15,12,10,11,48,83
2259,South Korea,Asia,c,2011,F,1,2,11,15,10,0,36,14,11,13,12,50,86
2260,South Ossetia,Eurasia,t,2011,NF,7,6,0,0,0,3,-3,5,1,1,3,10,7
2261,Spain,Europe,c,2011,F,1,1,12,16,12,0,40,16,12,14,15,57,97
2262,Sri Lanka,Asia,c,2011,PF,5,4,6,6,5,0,17,8,6,6,8,28,45
2263,St. Kitts and Nevis,Americas,c,2011,F,1,1,12,16,11,0,39,15,12,12,14,53,92
2264,St. Lucia,Americas,c,2011,F,1,1,12,16,11,0,39,15,12,12,14,53,92
2265,St. Vincent and the Grenadines,Americas,c,2011,F,1,1,11,16,9,0,36,15,11,13,14,53,89
2266,Sudan,SSA,c,2011,NF,7,7,2,4,3,4,5,4,2,0,0,6,11
2267,Suriname,Americas,c,2011,F,2,2,12,13,8,0,33,15,11,9,10,45,78
2268,Swaziland,SSA,c,2011,NF,7,5,0,1,1,0,3,8,3,5,4,20,23
2269,Sweden,Europe,c,2011,F,1,1,12,16,12,0,40,16,12,16,16,60,100
2270,Switzerland,Europe,c,2011,F,1,1,12,15,12,0,39,15,12,15,15,57,96
2271,Syria,MENA,c,2011,NF,7,6,0,0,1,0,1,2,0,1,5,8,9
2272,Taiwan,Asia,c,2011,F,1,2,11,15,10,0,36,14,10,14,13,51,87
2273,Tajikistan,Eurasia,c,2011,NF,6,5,2,4,2,0,8,6,4,4,4,18,26
2274,Tanzania,SSA,c,2011,PF,3,3,9,12,7,0,28,11,7,10,8,36,64
2275,Thailand,Asia,c,2011,PF,5,4,3,5,4,0,12,9,5,6,10,30,42
2276,The Gambia,SSA,c,2011,PF,5,5,6,7,2,0,15,8,4,4,7,23,38
2277,Tibet,Asia,t,2011,NF,7,7,0,0,1,3,-2,0,0,0,3,3,1
2278,Timor-Leste,Asia,c,2011,PF,3,4,11,11,6,0,28,12,7,6,9,34,62
2279,Togo,SSA,c,2011,PF,5,4,5,8,3,0,16,8,5,6,7,26,42
2280,Tonga,Asia,c,2011,PF,3,3,11,14,4,0,29,12,7,11,12,42,71
2281,Transnistria,Eurasia,t,2011,NF,6,6,2,4,1,0,7,6,2,2,5,15,22
2282,Trinidad and Tobago,Americas,c,2011,F,2,2,11,13,9,0,33,15,11,10,13,49,82
2283,Tunisia,MENA,c,2011,NF,7,5,1,3,1,0,5,4,2,4,8,18,23
2284,Turkey,Europe,c,2011,PF,3,3,10,10,7,0,27,11,7,8,10,36,63
2285,Turkmenistan,Eurasia,c,2011,NF,7,7,0,1,0,0,1,3,0,1,3,7,8
2286,Tuvalu,Asia,c,2011,F,1,1,12,15,10,0,37,16,12,15,14,57,94
2287,Uganda,SSA,c,2011,PF,5,4,4,7,4,0,15,11,6,6,7,30,45
2288,Ukraine,Eurasia,c,2011,PF,3,3,9,13,5,0,27,11,9,9,11,40,67
2289,United Arab Emirates,MENA,c,2011,NF,6,5,1,2,2,0,8,8,3,4,4,19,27
2290,United Kingdom,Europe,c,2011,F,1,1,12,16,12,0,40,15,12,15,15,57,97
2291,United States,Americas,c,2011,F,1,1,11,16,11,0,38,16,11,14,15,56,94
2292,Uruguay,Americas,c,2011,F,1,1,12,16,11,0,39,16,12,15,15,58,97
2293,Uzbekistan,Eurasia,c,2011,NF,7,7,0,0,0,0,0,1,0,0,3,4,4
2294,Vanuatu,Asia,c,2011,F,2,2,9,15,8,0,32,16,11,10,11,48,80
2295,Venezuela,Americas,c,2011,PF,5,5,6,8,3,0,17,9,4,5,7,25,42
2296,Vietnam,Asia,c,2011,NF,7,5,0,1,1,0,2,5,1,4,8,18,20
2297,West Bank,MENA,t,2011,NF,6,5,2,5,2,2,7,9,6,5,5,25,32
2298,Western Sahara,MENA,t,2011,NF,7,6,0,0,0,2,-2,3,2,0,5,10,8
2299,Yemen,MENA,c,2011,NF,6,5,4,4,3,0,11,7,3,3,5,18,29
2300,Zambia,SSA,c,2011,PF,3,4,8,11,6,0,25,11,7,8,7,33,58
2301,Zimbabwe,SSA,c,2011,NF,6,6,2,4,2,0,8,5,3,1,4,13,21
2302,Abkhazia,Eurasia,t,2010,PF,5,5,5,5,4,0,14,7,5,4,5,21,35
2303,Afghanistan,Asia,c,2010,NF,6,6,4,6,1,0,11,5,4,2,5,16,27
2304,Albania,Europe,c,2010,PF,3,3,8,11,7,0,26,13,8,9,9,39,65
2305,Algeria,MENA,c,2010,NF,6,5,4,4,3,0,11,7,6,5,7,25,36
2306,Andorra,Europe,c,2010,F,1,1,12,15,12,0,39,16,11,15,15,57,96
2307,Angola,SSA,c,2010,NF,6,5,3,6,1,0,10,8,6,4,3,21,31
2308,Antigua and Barbuda,Americas,c,2010,F,3,2,11,12,6,0,29,13,9,12,13,47,76
2309,Argentina,Americas,c,2010,F,2,2,11,15,6,0,32,14,11,10,13,48,80
2310,Armenia,Eurasia,c,2010,PF,6,4,4,4,3,0,11,8,5,6,9,28,39
2311,Australia,Asia,c,2010,F,1,1,12,15,12,0,39,16,12,14,15,57,96
2312,Austria,Europe,c,2010,F,1,1,12,15,12,0,39,16,12,15,15,58,97
2313,Azerbaijan,Eurasia,c,2010,NF,6,5,2,3,3,0,8,6,3,4,8,21,29
2314,Bahamas,Americas,c,2010,F,1,1,12,16,10,0,38,16,12,15,15,58,96
2315,Bahrain,MENA,c,2010,NF,6,5,3,6,4,2,11,8,3,3,7,21,32
2316,Bangladesh,Asia,c,2010,PF,3,4,9,11,6,0,26,9,8,7,9,33,59
2317,Barbados,Americas,c,2010,F,1,1,12,16,12,0,40,16,12,16,15,59,99
2318,Belarus,Eurasia,c,2010,NF,7,6,0,3,1,0,4,3,1,2,5,11,15
2319,Belgium,Europe,c,2010,F,1,1,12,16,12,0,40,16,12,15,15,58,98
2320,Belize,Americas,c,2010,F,1,2,12,14,11,0,37,15,11,12,13,51,88
2321,Benin,SSA,c,2010,F,2,2,9,15,8,0,32,15,12,11,10,48,80
2322,Bhutan,Asia,c,2010,PF,4,5,7,7,6,1,19,8,3,5,8,24,43
2323,Bolivia,Americas,c,2010,PF,3,3,11,12,5,0,28,14,10,7,9,40,68
2324,Bosnia and Herzegovina,Europe,c,2010,PF,4,3,8,10,5,0,23,11,7,10,10,38,61
2325,Botswana,SSA,c,2010,F,3,2,10,11,8,0,29,13,10,12,11,46,75
2326,Brazil,Americas,c,2010,F,2,2,11,14,7,0,32,15,10,8,12,45,77
2327,Brunei,Asia,c,2010,NF,6,5,0,3,3,0,7,6,3,6,8,23,30
2328,Bulgaria,Europe,c,2010,F,2,2,12,15,8,0,35,14,11,11,11,47,82
2329,Burkina Faso,SSA,c,2010,PF,5,3,5,8,4,0,17,13,8,6,8,35,52
2330,Burundi,SSA,c,2010,PF,4,5,9,9,4,0,22,8,5,4,6,23,45
2331,Cambodia,Asia,c,2010,NF,6,5,3,5,3,0,11,9,5,1,6,21,32
2332,Cameroon,SSA,c,2010,NF,6,6,2,3,3,0,8,7,3,2,4,16,24
2333,Canada,Americas,c,2010,F,1,1,12,16,12,0,40,16,12,15,16,59,99
2334,Cape Verde,SSA,c,2010,F,1,1,12,15,10,0,37,15,11,14,13,53,90
2335,Central African Republic,SSA,c,2010,PF,5,5,7,7,3,0,17,10,5,3,4,22,39
2336,Chad,SSA,c,2010,NF,7,6,3,1,1,0,5,7,4,1,3,15,20
2337,Chile,Americas,c,2010,F,1,1,12,15,12,0,39,16,12,15,15,58,97
2338,China,Asia,c,2010,NF,7,6,0,1,1,1,1,4,3,2,7,16,17
2339,Colombia,Americas,c,2010,PF,3,4,10,9,7,0,26,11,5,7,10,33,59
2340,Comoros,SSA,c,2010,PF,3,4,9,11,5,0,25,10,6,8,6,30,55
2341,Congo (Brazzaville),SSA,c,2010,NF,6,5,1,3,3,0,7,8,6,2,6,22,29
2342,Congo (Kinshasa),SSA,c,2010,NF,6,6,6,3,2,0,11,6,3,0,1,10,21
2343,Costa Rica,Americas,c,2010,F,1,1,12,15,11,0,38,16,11,13,13,53,91
2344,Cote d'Ivoire,SSA,c,2010,NF,6,5,1,3,2,0,6,5,4,6,5,20,26
2345,Croatia,Europe,c,2010,F,1,2,12,15,9,0,36,14,12,11,13,50,86
2346,Cuba,Americas,c,2010,NF,7,6,0,0,1,0,1,2,1,2,3,8,9
2347,Cyprus,Europe,c,2010,F,1,1,11,16,11,0,38,15,12,15,14,56,94
2348,Czech Republic,Europe,c,2010,F,1,1,12,15,11,0,38,16,12,14,15,57,95
2349,Denmark,Europe,c,2010,F,1,1,12,16,12,0,40,16,11,14,15,56,96
2350,Djibouti,SSA,c,2010,PF,5,5,4,5,3,0,12,7,5,5,6,23,35
2351,Dominica,Americas,c,2010,F,1,1,12,16,10,0,38,16,12,15,15,58,96
2352,Dominican Republic,Americas,c,2010,F,2,2,11,13,9,0,33,15,11,8,11,45,78
2353,Ecuador,Americas,c,2010,PF,3,3,9,14,6,0,29,14,9,6,10,39,68
2354,Egypt,MENA,c,2010,NF,6,5,1,4,2,0,7,7,2,4,7,20,27
2355,El Salvador,Americas,c,2010,F,2,3,12,14,8,0,34,15,8,7,10,40,74
2356,Equatorial Guinea,SSA,c,2010,NF,7,7,0,1,0,0,1,4,0,0,3,7,8
2357,Eritrea,SSA,c,2010,NF,7,7,0,1,2,0,3,1,0,0,4,5,8
2358,Estonia,Europe,c,2010,F,1,1,12,15,12,0,39,16,12,14,14,56,95
2359,Ethiopia,SSA,c,2010,PF,5,5,5,4,4,0,13,6,2,4,6,18,31
2360,Fiji,Asia,c,2010,PF,6,4,0,5,2,0,7,10,4,7,10,31,38
2361,Finland,Europe,c,2010,F,1,1,12,16,12,0,40,16,12,16,16,60,100
2362,France,Europe,c,2010,F,1,1,12,15,11,0,38,16,12,15,15,58,96
2363,Gabon,SSA,c,2010,NF,6,5,2,4,3,0,9,10,4,6,5,25,34
2364,Georgia,Eurasia,c,2010,PF,4,4,6,8,6,0,20,11,7,6,10,34,54
2365,Germany,Europe,c,2010,F,1,1,12,15,12,0,39,15,12,15,15,57,96
2366,Ghana,SSA,c,2010,F,1,2,12,15,10,0,37,14,11,12,10,47,84
2367,Greece,Europe,c,2010,F,1,2,12,15,9,0,36,14,12,11,13,50,86
2368,Grenada,Americas,c,2010,F,1,2,12,16,10,0,38,15,10,12,15,52,90
2369,Guatemala,Americas,c,2010,PF,4,4,9,10,4,0,23,12,8,5,8,33,56
2370,Guinea,SSA,c,2010,NF,7,6,0,2,0,0,2,6,2,0,5,13,15
2371,Guinea-Bissau,SSA,c,2010,PF,4,4,9,9,3,0,21,10,8,4,5,27,48
2372,Guyana,Americas,c,2010,F,2,3,11,13,7,0,31,15,10,7,9,41,72
2373,Haiti,Americas,c,2010,PF,4,5,7,10,5,0,22,10,6,4,5,25,47
2374,Honduras,Americas,c,2010,PF,4,4,6,8,4,0,18,11,6,7,9,33,51
2375,Hong Kong,Asia,t,2010,PF,5,2,3,7,6,0,16,14,10,15,13,52,68
2376,Hungary,Europe,c,2010,F,1,1,12,15,10,0,37,16,12,12,14,54,91
2377,Iceland,Europe,c,2010,F,1,1,12,16,12,0,40,16,12,16,15,59,99
2378,India,Asia,c,2010,F,2,3,11,14,9,0,34,13,10,9,10,42,76
2379,Indian Kashmir,Asia,t,2010,PF,4,4,8,8,4,0,20,8,6,4,8,26,46
2380,Indonesia,Asia,c,2010,F,2,3,11,13,6,0,30,11,9,6,9,35,65
2381,Iran,MENA,c,2010,NF,6,6,2,2,3,0,7,3,3,3,4,13,20
2382,Iraq,MENA,c,2010,NF,5,6,7,5,2,2,12,5,4,1,4,14,26
2383,Ireland,Europe,c,2010,F,1,1,12,16,11,0,39,16,12,15,15,58,97
2384,Israel,MENA,c,2010,F,1,2,12,14,10,0,36,13,11,11,11,46,82
2385,Israeli Occupied Territories,MENA,t,2010,NF,6,6,3,2,3,2,6,6,5,1,3,15,21
2386,Italy,Europe,c,2010,F,1,2,12,15,10,0,37,14,12,12,14,52,89
2387,Jamaica,Americas,c,2010,F,2,3,12,14,8,0,34,15,9,7,10,41,75
2388,Japan,Asia,c,2010,F,1,2,12,15,10,0,37,13,10,15,13,51,88
2389,Jordan,MENA,c,2010,NF,6,5,2,5,3,0,10,7,3,6,8,24,34
2390,Kazakhstan,Eurasia,c,2010,NF,6,5,2,3,2,0,7,7,3,4,7,21,28
2391,Kenya,SSA,c,2010,PF,4,4,6,9,4,0,19,13,8,6,6,33,52
2392,Kiribati,Asia,c,2010,F,1,1,12,16,8,0,36,15,12,15,13,55,91
2393,Kosovo,Europe,c,2010,PF,5,4,6,7,3,2,14,8,6,5,7,26,40
2394,Kuwait,MENA,c,2010,PF,4,4,4,9,6,0,19,8,6,7,6,27,46
2395,Kyrgyzstan,Eurasia,c,2010,NF,6,5,3,5,3,0,11,8,5,5,7,25,36
2396,Laos,Asia,c,2010,NF,7,6,0,1,0,0,1,4,1,2,5,12,13
2397,Latvia,Europe,c,2010,F,2,1,12,14,7,0,33,16,12,12,13,53,86
2398,Lebanon,MENA,c,2010,PF,5,3,5,9,3,0,17,12,8,6,9,35,52
2399,Lesotho,SSA,c,2010,PF,3,3,9,11,9,0,29,14,7,11,9,41,70
2400,Liberia,SSA,c,2010,PF,3,4,8,10,6,0,24,11,8,7,8,34,58
2401,Libya,MENA,c,2010,NF,7,7,0,1,0,0,1,1,0,0,6,7,8
2402,Liechtenstein,Europe,c,2010,F,1,1,12,16,12,0,40,16,12,16,16,60,100
2403,Lithuania,Europe,c,2010,F,1,1,12,16,9,0,37,16,11,13,13,53,90
2404,Luxembourg,Europe,c,2010,F,1,1,12,16,12,0,40,16,12,16,16,60,100
2405,Macedonia,Europe,c,2010,PF,3,3,8,10,7,0,25,12,7,9,10,38,63
2406,Madagascar,SSA,c,2010,PF,6,4,2,5,2,0,9,10,7,6,9,32,41
2407,Malawi,SSA,c,2010,PF,3,4,8,11,7,0,26,11,8,8,7,34,60
2408,Malaysia,Asia,c,2010,PF,4,4,6,8,6,0,20,9,6,6,8,29,49
2409,Maldives,Asia,c,2010,PF,3,4,9,9,7,0,25,8,8,8,8,32,57
2410,Mali,SSA,c,2010,F,2,3,9,13,9,0,31,16,10,7,7,40,71
2411,Malta,Europe,c,2010,F,1,1,12,16,11,0,39,16,12,15,15,58,97
2412,Marshall Islands,Asia,c,2010,F,1,1,11,15,10,0,36,16,11,15,13,55,91
2413,Mauritania,SSA,c,2010,NF,6,5,3,3,5,0,11,9,5,4,5,23,34
2414,Mauritius,SSA,c,2010,F,1,2,12,15,11,0,38,15,12,13,12,52,90
2415,Mexico,Americas,c,2010,F,2,3,10,12,8,0,30,14,8,6,11,39,69
2416,Micronesia,Asia,c,2010,F,1,1,12,15,10,0,37,16,11,15,14,56,93
2417,Moldova,Eurasia,c,2010,PF,3,4,9,11,5,0,25,10,6,8,9,33,58
2418,Monaco,Europe,c,2010,F,2,1,10,11,10,0,31,15,12,15,14,56,87
2419,Mongolia,Asia,c,2010,F,2,2,10,15,10,0,35,15,11,12,12,50,85
2420,Montenegro,Europe,c,2010,F,3,2,9,9,7,0,25,13,10,9,12,44,69
2421,Morocco,MENA,c,2010,PF,5,4,4,6,4,0,14,8,6,6,8,28,42
2422,Mozambique,SSA,c,2010,PF,4,3,6,10,7,0,23,12,7,8,9,36,59
2423,Myanmar,Asia,c,2010,NF,7,7,0,0,0,3,-3,2,0,0,3,5,2
2424,Nagorno-Karabakh,Eurasia,t,2010,PF,5,5,6,4,3,0,13,6,3,5,5,19,32
2425,Namibia,SSA,c,2010,F,2,2,10,11,9,0,30,15,12,10,9,46,76
2426,Nauru,Asia,c,2010,F,1,1,12,16,10,0,38,15,11,15,14,55,93
2427,Nepal,Asia,c,2010,PF,4,4,6,11,4,0,21,10,6,6,7,29,50
2428,Netherlands,Europe,c,2010,F,1,1,12,16,12,0,40,16,12,15,16,59,99
2429,New Zealand,Asia,c,2010,F,1,1,12,15,12,0,39,16,12,15,15,58,97
2430,Nicaragua,Americas,c,2010,PF,4,4,9,7,4,0,20,12,6,7,9,34,54
2431,Niger,SSA,c,2010,PF,5,4,3,6,4,0,13,10,8,5,6,29,42
2432,Nigeria,SSA,c,2010,PF,5,4,3,7,6,0,16,9,8,5,7,29,45
2433,North Korea,Asia,c,2010,NF,7,7,0,0,0,0,0,0,0,0,1,1,1
2434,Northern Cyprus,Europe,t,2010,F,2,2,11,14,9,0,34,14,9,12,12,47,81
2435,Norway,Europe,c,2010,F,1,1,12,16,12,0,40,16,12,16,16,60,100
2436,Oman,MENA,c,2010,NF,6,5,2,2,2,0,9,6,3,4,5,18,27
2437,Pakistan,Asia,c,2010,PF,4,5,6,9,4,0,19,7,7,4,6,24,43
2438,Pakistani Kashmir,Asia,t,2010,NF,6,5,3,4,3,2,8,6,5,4,6,21,29
2439,Palau,Asia,c,2010,F,1,1,12,15,10,0,37,16,11,15,13,55,92
2440,Palestinian Authority Administered Territories,MENA,t,2010,NF,6,6,4,5,2,0,11,5,3,1,5,14,25
2441,Panama,Americas,c,2010,F,1,2,12,15,9,0,36,15,11,9,12,47,83
2442,Papua New Guinea,Asia,c,2010,PF,4,3,9,10,4,0,23,12,9,7,8,36,59
2443,Paraguay,Americas,c,2010,PF,3,3,11,12,5,0,28,12,8,6,10,36,64
2444,Peru,Americas,c,2010,F,2,3,11,13,7,0,31,15,8,8,10,41,72
2445,Philippines,Asia,c,2010,PF,4,3,6,9,6,0,21,13,8,5,10,36,57
2446,Poland,Europe,c,2010,F,1,1,12,16,10,0,38,16,12,13,14,55,93
2447,Portugal,Europe,c,2010,F,1,1,12,16,11,0,39,16,12,15,15,58,97
2448,Puerto Rico,Americas,t,2010,F,1,1,12,15,10,0,37,16,11,14,14,55,92
2449,Qatar,MENA,c,2010,NF,6,5,2,2,3,0,10,8,2,4,4,18,28
2450,Romania,Europe,c,2010,F,2,2,12,14,8,0,34,14,11,12,12,49,83
2451,Russia,Eurasia,c,2010,NF,6,5,1,3,3,0,7,6,4,3,7,20,27
2452,Rwanda,SSA,c,2010,NF,6,5,3,3,4,0,10,7,4,6,7,24,34
2453,Samoa,Asia,c,2010,F,2,2,9,13,10,0,32,14,10,13,12,49,81
2454,San Marino,Europe,c,2010,F,1,1,12,16,12,0,40,16,12,16,16,60,100
2455,Sao Tome and Principe,SSA,c,2010,F,2,2,11,14,8,0,33,15,10,12,10,47,80
2456,Saudi Arabia,MENA,c,2010,NF,7,6,0,0,1,0,3,4,0,3,2,9,12
2457,Senegal,SSA,c,2010,PF,3,3,9,12,8,0,29,14,10,10,9,43,72
2458,Serbia,Europe,c,2010,F,2,2,9,14,7,0,30,15,11,9,13,48,78
2459,Seychelles,SSA,c,2010,PF,3,3,8,10,7,0,25,11,9,11,11,42,67
2460,Sierra Leone,SSA,c,2010,PF,3,3,10,11,6,0,27,12,8,8,9,37,64
2461,Singapore,Asia,c,2010,PF,5,4,4,6,7,0,17,9,3,7,12,31,48
2462,Slovakia,Europe,c,2010,F,1,1,12,15,10,0,37,15,12,12,14,53,90
2463,Slovenia,Europe,c,2010,F,1,1,12,15,11,0,38,14,12,14,13,53,91
2464,Solomon Islands,Asia,c,2010,PF,4,3,6,10,6,0,22,13,9,8,12,42,64
2465,Somalia,SSA,c,2010,NF,7,7,0,0,0,0,0,1,0,0,0,1,1
2466,Somaliland,SSA,t,2010,PF,5,5,4,7,5,0,16,7,5,6,6,24,40
2467,South Africa,SSA,c,2010,F,2,2,12,14,9,0,35,15,12,10,12,49,84
2468,South Korea,Asia,c,2010,F,1,2,11,15,10,0,36,14,11,13,12,50,86
2469,South Ossetia,Eurasia,t,2010,NF,7,6,0,0,0,3,-3,4,0,1,3,8,5
2470,Spain,Europe,c,2010,F,1,1,12,16,12,0,40,16,12,14,15,57,97
2471,Sri Lanka,Asia,c,2010,PF,4,4,8,8,6,0,22,8,7,6,9,30,52
2472,St. Kitts and Nevis,Americas,c,2010,F,1,1,12,16,11,0,39,15,12,12,14,53,92
2473,St. Lucia,Americas,c,2010,F,1,1,12,16,11,0,39,15,12,12,14,53,92
2474,St. Vincent and the Grenadines,Americas,c,2010,F,2,1,11,15,9,0,35,15,11,13,14,53,88
2475,Sudan,SSA,c,2010,NF,7,7,0,4,3,4,3,4,2,0,0,6,9
2476,Suriname,Americas,c,2010,F,2,2,12,13,8,0,33,15,11,9,10,45,78
2477,Swaziland,SSA,c,2010,NF,7,5,0,1,1,0,3,8,3,5,5,21,24
2478,Sweden,Europe,c,2010,F,1,1,12,16,12,0,40,16,12,16,16,60,100
2479,Switzerland,Europe,c,2010,F,1,1,12,15,12,0,39,15,12,15,15,57,96
2480,Syria,MENA,c,2010,NF,7,6,0,0,1,0,1,2,0,1,5,8,9
2481,Taiwan,Asia,c,2010,F,1,2,11,15,10,0,36,15,10,14,13,52,88
2482,Tajikistan,Eurasia,c,2010,NF,6,5,2,4,2,0,8,6,4,4,5,19,27
2483,Tanzania,SSA,c,2010,PF,4,3,6,9,6,0,21,11,7,10,8,36,57
2484,Thailand,Asia,c,2010,PF,5,4,3,5,4,0,12,9,6,6,11,32,44
2485,The Gambia,SSA,c,2010,PF,5,5,6,7,2,0,15,8,5,4,7,24,39
2486,Tibet,Asia,t,2010,NF,7,7,0,0,1,3,-2,0,0,0,3,3,1
2487,Timor-Leste,Asia,c,2010,PF,3,4,11,11,6,0,28,12,7,6,9,34,62
2488,Togo,SSA,c,2010,PF,5,4,5,8,3,0,16,8,6,6,7,27,43
2489,Tonga,Asia,c,2010,PF,5,3,3,9,3,0,15,12,5,11,12,40,55
2490,Transnistria,Eurasia,t,2010,NF,6,6,2,4,1,0,7,6,2,2,5,15,22
2491,Trinidad and Tobago,Americas,c,2010,F,2,2,11,12,9,0,32,15,11,10,13,49,81
2492,Tunisia,MENA,c,2010,NF,7,5,1,3,1,0,5,4,2,4,8,18,23
2493,Turkey,Europe,c,2010,PF,3,3,10,10,7,0,27,11,7,8,10,36,63
2494,Turkmenistan,Eurasia,c,2010,NF,7,7,0,1,0,0,1,3,0,1,3,7,8
2495,Tuvalu,Asia,c,2010,F,1,1,12,15,10,0,37,16,12,15,14,57,94
2496,Uganda,SSA,c,2010,PF,5,4,4,7,4,0,15,11,6,6,7,30,45
2497,Ukraine,Eurasia,c,2010,F,3,2,10,13,5,0,28,13,11,10,11,45,73
2498,United Arab Emirates,MENA,c,2010,NF,6,5,1,2,2,0,8,8,3,4,4,19,27
2499,United Kingdom,Europe,c,2010,F,1,1,12,16,12,0,40,15,12,14,15,56,96
2500,United States,Americas,c,2010,F,1,1,11,16,11,0,38,16,11,14,15,56,94
2501,Uruguay,Americas,c,2010,F,1,1,12,16,11,0,39,16,12,15,15,58,97
2502,Uzbekistan,Eurasia,c,2010,NF,7,7,0,0,0,0,0,1,0,0,3,4,4
2503,Vanuatu,Asia,c,2010,F,2,2,9,15,8,0,32,16,11,10,11,48,80
2504,Venezuela,Americas,c,2010,PF,5,4,6,7,3,0,16,9,5,5,8,27,43
2505,Vietnam,Asia,c,2010,NF,7,5,0,1,1,0,2,6,1,4,8,19,21
2506,Western Sahara,MENA,t,2010,NF,7,6,0,0,0,2,-2,3,2,0,5,10,8
2507,Yemen,MENA,c,2010,NF,6,5,4,4,3,0,11,7,3,3,5,18,29
2508,Zambia,SSA,c,2010,PF,3,4,8,12,6,0,26,11,7,9,7,34,60
2509,Zimbabwe,SSA,c,2010,NF,6,6,2,4,1,0,7,4,3,1,2,10,17
2510,Abkhazia,Eurasia,t,2009,PF,5,5,5,5,4,0,14,8,4,4,5,21,35
2511,Afghanistan,Asia,c,2009,NF,5,6,6,7,3,0,16,5,4,2,5,16,32
2512,Albania,Europe,c,2009,PF,3,3,8,11,7,0,26,13,8,10,9,40,66
2513,Algeria,MENA,c,2009,NF,6,5,4,4,3,0,11,7,6,5,7,25,36
2514,Andorra,Europe,c,2009,F,1,1,12,15,12,0,39,16,11,15,15,57,96
2515,Angola,SSA,c,2009,NF,6,5,4,6,1,0,11,8,6,4,3,21,32
2516,Antigua and Barbuda,Americas,c,2009,F,2,2,11,12,7,0,30,13,9,12,13,47,77
2517,Argentina,Americas,c,2009,F,2,2,11,15,6,0,32,14,11,10,13,48,80
2518,Armenia,Eurasia,c,2009,PF,6,4,4,4,3,0,11,8,5,5,9,27,38
2519,Australia,Asia,c,2009,F,1,1,12,15,12,0,39,16,12,14,15,57,96
2520,Austria,Europe,c,2009,F,1,1,12,15,12,0,39,16,12,15,15,58,97
2521,Azerbaijan,Eurasia,c,2009,NF,6,5,2,3,3,0,8,6,3,4,8,21,29
2522,Bahamas,Americas,c,2009,F,1,1,12,16,10,0,38,16,12,15,15,58,96
2523,Bahrain,MENA,c,2009,PF,5,5,3,8,4,2,13,8,3,3,7,21,34
2524,Bangladesh,Asia,c,2009,PF,4,4,9,9,4,0,22,8,8,5,9,30,52
2525,Barbados,Americas,c,2009,F,1,1,12,16,12,0,40,16,12,16,15,59,99
2526,Belarus,Eurasia,c,2009,NF,7,6,0,3,1,0,4,3,1,2,5,11,15
2527,Belgium,Europe,c,2009,F,1,1,12,16,11,0,39,16,12,15,15,58,97
2528,Belize,Americas,c,2009,F,1,2,12,14,10,0,36,15,11,12,13,51,87
2529,Benin,SSA,c,2009,F,2,2,9,15,8,0,32,15,12,11,10,48,80
2530,Bhutan,Asia,c,2009,PF,4,5,7,7,6,1,19,8,3,5,8,24,43
2531,Bolivia,Americas,c,2009,PF,3,3,11,12,5,0,28,14,10,7,9,40,68
2532,Bosnia and Herzegovina,Europe,c,2009,PF,4,3,8,10,5,0,23,11,7,10,10,38,61
2533,Botswana,SSA,c,2009,F,2,2,10,11,9,0,30,14,10,13,11,48,78
2534,Brazil,Americas,c,2009,F,2,2,11,14,7,0,32,15,10,8,12,45,77
2535,Brunei,Asia,c,2009,NF,6,5,0,3,3,0,7,6,3,6,8,23,30
2536,Bulgaria,Europe,c,2009,F,2,2,12,15,8,0,35,14,11,11,11,47,82
2537,Burkina Faso,SSA,c,2009,PF,5,3,5,8,4,0,17,13,8,6,8,35,52
2538,Burundi,SSA,c,2009,PF,4,5,8,8,4,0,20,8,5,4,6,23,43
2539,Cambodia,Asia,c,2009,NF,6,5,3,5,3,0,11,10,5,2,6,23,34
2540,Cameroon,SSA,c,2009,NF,6,6,2,3,3,0,8,7,2,2,4,15,23
2541,Canada,Americas,c,2009,F,1,1,12,16,11,0,39,15,12,15,16,58,97
2542,Cape Verde,SSA,c,2009,F,1,1,12,15,10,0,37,15,11,14,13,53,90
2543,Central African Republic,SSA,c,2009,PF,5,5,7,7,3,0,17,10,6,3,4,23,40
2544,Chad,SSA,c,2009,NF,7,6,3,1,1,0,5,7,4,1,3,15,20
2545,Chechnya,Eurasia,t,2009,NF,7,7,0,0,0,0,0,4,0,0,3,7,7
2546,Chile,Americas,c,2009,F,1,1,12,15,12,0,39,16,12,15,15,58,97
2547,China,Asia,c,2009,NF,7,6,0,1,1,0,2,3,2,2,7,14,16
2548,Colombia,Americas,c,2009,PF,3,4,10,9,7,0,26,12,5,7,10,34,60
2549,Comoros,SSA,c,2009,PF,3,4,9,11,5,0,25,10,6,8,6,30,55
2550,Congo (Brazzaville),SSA,c,2009,NF,6,5,2,4,3,0,9,9,7,2,6,24,33
2551,Congo (Kinshasa),SSA,c,2009,NF,6,6,6,3,2,0,11,6,4,0,1,11,22
2552,Costa Rica,Americas,c,2009,F,1,1,12,15,11,0,38,16,11,13,13,53,91
2553,Cote d'Ivoire,SSA,c,2009,NF,6,5,1,3,2,0,6,5,4,5,5,19,25
2554,Croatia,Europe,c,2009,F,2,2,12,14,9,0,35,14,12,10,13,49,84
2555,Cuba,Americas,c,2009,NF,7,6,0,0,1,0,1,2,1,2,3,8,9
2556,Cyprus,Europe,c,2009,F,1,1,11,16,11,0,38,15,12,15,15,57,95
2557,Czech Republic,Europe,c,2009,F,1,1,12,15,11,0,38,16,12,14,15,57,95
2558,Denmark,Europe,c,2009,F,1,1,12,16,12,0,40,16,12,14,15,57,97
2559,Djibouti,SSA,c,2009,PF,5,5,4,5,3,0,12,6,5,5,6,22,34
2560,Dominica,Americas,c,2009,F,1,1,12,16,11,0,39,16,12,15,15,58,97
2561,Dominican Republic,Americas,c,2009,F,2,2,11,13,9,0,33,15,11,10,12,48,81
2562,Ecuador,Americas,c,2009,PF,3,3,9,14,6,0,29,14,10,6,10,40,69
2563,Egypt,MENA,c,2009,NF,6,5,1,4,2,0,7,5,2,4,7,18,25
2564,El Salvador,Americas,c,2009,F,2,3,12,13,8,0,33,15,8,7,10,40,73
2565,Equatorial Guinea,SSA,c,2009,NF,7,7,0,1,0,0,1,4,0,0,3,7,8
2566,Eritrea,SSA,c,2009,NF,7,6,0,1,2,0,3,2,0,2,6,10,13
2567,Estonia,Europe,c,2009,F,1,1,12,15,12,0,39,16,12,14,14,56,95
2568,Ethiopia,SSA,c,2009,PF,5,5,5,4,4,0,13,7,3,4,6,20,33
2569,Fiji,Asia,c,2009,PF,6,4,0,5,2,0,7,10,4,7,10,31,38
2570,Finland,Europe,c,2009,F,1,1,12,16,12,0,40,16,12,16,16,60,100
2571,France,Europe,c,2009,F,1,1,12,15,11,0,38,16,12,15,15,58,96
2572,Gabon,SSA,c,2009,PF,6,4,2,5,3,0,10,10,5,6,5,26,36
2573,Georgia,Eurasia,c,2009,PF,4,4,6,6,6,0,18,11,7,5,10,33,51
2574,Germany,Europe,c,2009,F,1,1,12,15,12,0,39,15,12,15,15,57,96
2575,Ghana,SSA,c,2009,F,1,2,12,15,10,0,37,14,11,12,10,47,84
2576,Greece,Europe,c,2009,F,1,2,12,15,10,0,37,14,12,12,13,51,88
2577,Grenada,Americas,c,2009,F,1,2,12,16,10,0,38,15,10,12,15,52,90
2578,Guatemala,Americas,c,2009,PF,3,4,9,10,5,0,24,12,8,5,8,33,57
2579,Guinea,SSA,c,2009,NF,7,5,1,3,1,0,5,8,5,4,6,23,28
2580,Guinea-Bissau,SSA,c,2009,PF,4,4,9,9,3,0,21,10,8,6,5,29,50
2581,Guyana,Americas,c,2009,F,2,3,11,13,7,0,31,15,10,8,9,42,73
2582,Haiti,Americas,c,2009,PF,4,5,7,10,5,0,22,10,6,4,5,25,47
2583,Honduras,Americas,c,2009,PF,3,3,9,10,6,0,25,12,7,7,9,35,60
2584,Hong Kong,Asia,t,2009,PF,5,2,3,7,6,0,16,14,10,15,13,52,68
2585,Hungary,Europe,c,2009,F,1,1,12,15,10,0,37,16,12,13,14,55,92
2586,Iceland,Europe,c,2009,F,1,1,12,16,12,0,40,16,12,16,16,60,100
2587,India,Asia,c,2009,F,2,3,11,14,9,0,34,13,10,9,10,42,76
2588,Indian Kashmir,Asia,t,2009,PF,5,4,6,8,3,0,17,8,6,4,8,26,43
2589,Indonesia,Asia,c,2009,F,2,3,11,13,6,0,30,11,9,7,9,36,66
2590,Iran,MENA,c,2009,NF,6,6,3,3,3,0,9,4,2,3,4,13,22
2591,Iraq,MENA,c,2009,NF,6,6,7,5,1,2,11,5,3,1,4,13,24
2592,Ireland,Europe,c,2009,F,1,1,12,16,11,0,39,16,12,15,15,58,97
2593,Israel,MENA,c,2009,F,1,2,12,15,10,0,37,13,12,11,11,47,84
2594,Israeli Occupied Territories,MENA,t,2009,NF,6,6,3,2,3,2,6,6,5,1,3,15,21
2595,Italy,Europe,c,2009,F,1,2,12,15,11,0,38,14,12,12,14,52,90
2596,Jamaica,Americas,c,2009,F,2,3,12,14,8,0,34,15,9,7,10,41,75
2597,Japan,Asia,c,2009,F,1,2,12,15,10,0,37,13,10,15,13,51,88
2598,Jordan,MENA,c,2009,PF,5,5,2,6,5,0,13,7,4,6,8,25,38
2599,Kazakhstan,Eurasia,c,2009,NF,6,5,2,3,2,0,7,7,4,4,8,23,30
2600,Kenya,SSA,c,2009,PF,4,3,6,9,4,0,19,13,9,7,6,35,54
2601,Kiribati,Asia,c,2009,F,1,1,12,16,8,0,36,15,12,15,13,55,91
2602,Kosovo,Europe,t,2009,NF,6,5,6,5,3,3,11,7,6,4,7,24,35
2603,Kuwait,MENA,c,2009,PF,4,4,4,9,6,0,19,9,6,7,5,27,46
2604,Kyrgyzstan,Eurasia,c,2009,PF,5,4,4,5,4,0,13,9,5,5,7,26,39
2605,Laos,Asia,c,2009,NF,7,6,0,1,0,0,1,4,1,2,5,12,13
2606,Latvia,Europe,c,2009,F,2,1,12,15,7,0,34,16,12,12,13,53,87
2607,Lebanon,MENA,c,2009,PF,5,4,5,8,4,0,17,12,8,5,9,34,51
2608,Lesotho,SSA,c,2009,F,2,3,9,12,9,0,30,14,7,11,9,41,71
2609,Liberia,SSA,c,2009,PF,3,4,9,10,6,0,25,11,8,7,8,34,59
2610,Libya,MENA,c,2009,NF,7,7,0,1,0,0,1,1,0,0,6,7,8
2611,Liechtenstein,Europe,c,2009,F,1,1,12,16,12,0,40,16,12,16,16,60,100
2612,Lithuania,Europe,c,2009,F,1,1,12,16,9,0,37,16,11,14,13,54,91
2613,Luxembourg,Europe,c,2009,F,1,1,12,16,12,0,40,16,12,16,16,60,100
2614,Macedonia,Europe,c,2009,PF,3,3,7,10,7,0,24,11,7,8,10,36,60
2615,Madagascar,SSA,c,2009,PF,4,3,7,8,7,0,22,10,8,9,9,36,58
2616,Malawi,SSA,c,2009,PF,4,4,7,10,6,0,23,11,8,8,7,34,57
2617,Malaysia,Asia,c,2009,PF,4,4,6,8,6,0,20,9,6,6,8,29,49
2618,Maldives,Asia,c,2009,PF,4,4,6,9,5,0,20,8,6,7,7,28,48
2619,Mali,SSA,c,2009,F,2,3,9,12,9,0,30,16,9,7,8,40,70
2620,Malta,Europe,c,2009,F,1,1,12,16,11,0,39,16,12,16,15,59,98
2621,Marshall Islands,Asia,c,2009,F,1,1,11,15,10,0,36,16,11,15,13,55,91
2622,Mauritania,SSA,c,2009,NF,6,5,2,3,4,0,9,9,5,4,5,23,32
2623,Mauritius,SSA,c,2009,F,1,2,12,15,11,0,38,15,12,13,12,52,90
2624,Mexico,Americas,c,2009,F,2,3,10,13,8,0,31,14,8,6,11,39,70
2625,Micronesia,Asia,c,2009,F,1,1,12,15,10,0,37,16,11,15,14,56,93
2626,Moldova,Eurasia,c,2009,PF,4,4,9,8,5,0,22,10,6,8,9,33,55
2627,Monaco,Europe,c,2009,F,2,1,10,11,10,0,31,15,12,15,14,56,87
2628,Mongolia,Asia,c,2009,F,2,2,9,15,10,0,34,15,9,12,12,48,82
2629,Montenegro,Europe,c,2009,PF,3,3,9,9,6,0,24,13,10,8,11,42,66
2630,Morocco,MENA,c,2009,PF,5,4,4,7,5,0,16,8,6,6,8,28,44
2631,Mozambique,SSA,c,2009,PF,3,3,7,11,7,0,25,12,7,8,9,36,61
2632,Myanmar,Asia,c,2009,NF,7,7,0,0,0,3,-3,2,0,0,3,5,2
2633,Nagorno-Karabakh,Eurasia,t,2009,PF,5,5,6,5,3,0,14,7,3,5,5,20,34
2634,Namibia,SSA,c,2009,F,2,2,10,11,9,0,30,15,11,10,9,45,75
2635,Nauru,Asia,c,2009,F,1,1,12,16,10,0,38,15,11,15,14,55,93
2636,Nepal,Asia,c,2009,PF,4,4,6,11,4,0,21,10,6,6,7,29,50
2637,Netherlands,Europe,c,2009,F,1,1,12,16,12,0,40,16,12,15,16,59,99
2638,New Zealand,Asia,c,2009,F,1,1,12,15,12,0,39,16,11,15,15,57,96
2639,Nicaragua,Americas,c,2009,PF,4,3,9,9,4,0,22,12,6,8,9,35,57
2640,Niger,SSA,c,2009,PF,3,4,11,9,8,0,28,10,8,6,6,30,58
2641,Nigeria,SSA,c,2009,PF,5,4,3,8,6,0,17,10,8,5,7,30,47
2642,North Korea,Asia,c,2009,NF,7,7,0,0,0,0,0,0,0,0,2,2,2
2643,Northern Cyprus,Europe,t,2009,F,2,2,11,14,9,0,34,14,9,12,12,47,81
2644,Norway,Europe,c,2009,F,1,1,12,16,12,0,40,16,12,16,16,60,100
2645,Oman,MENA,c,2009,NF,6,5,2,2,2,0,10,6,3,4,5,18,28
2646,Pakistan,Asia,c,2009,PF,4,5,6,8,4,0,18,7,7,2,6,22,40
2647,Pakistani Kashmir,Asia,t,2009,NF,6,5,2,3,3,2,6,6,5,4,6,21,27
2648,Palau,Asia,c,2009,F,1,1,12,15,10,0,37,16,11,15,13,55,92
2649,Palestinian Authority Administered Territories,MENA,t,2009,NF,5,6,4,5,3,0,12,5,3,1,4,13,25
2650,Panama,Americas,c,2009,F,1,2,12,15,9,0,36,15,11,9,12,47,83
2651,Papua New Guinea,Asia,c,2009,PF,4,3,9,10,4,0,23,12,9,7,8,36,59
2652,Paraguay,Americas,c,2009,PF,3,3,11,12,5,0,28,12,8,6,10,36,64
2653,Peru,Americas,c,2009,F,2,3,11,14,7,0,32,15,8,8,10,41,73
2654,Philippines,Asia,c,2009,PF,4,3,6,10,6,0,22,14,8,6,10,38,60
2655,Poland,Europe,c,2009,F,1,1,12,16,10,0,38,16,12,13,14,55,93
2656,Portugal,Europe,c,2009,F,1,1,12,16,11,0,39,16,12,15,15,58,97
2657,Puerto Rico,Americas,t,2009,F,1,1,12,15,10,0,37,16,11,14,14,55,92
2658,Qatar,MENA,c,2009,NF,6,5,2,2,3,0,10,8,2,4,4,18,28
2659,Romania,Europe,c,2009,F,2,2,12,14,8,0,34,14,11,12,12,49,83
2660,Russia,Eurasia,c,2009,NF,6,5,2,3,3,0,8,8,4,4,7,23,31
2661,Rwanda,SSA,c,2009,NF,6,5,3,4,4,0,11,7,3,6,7,23,34
2662,Samoa,Asia,c,2009,F,2,2,9,13,10,0,32,14,10,13,12,49,81
2663,San Marino,Europe,c,2009,F,1,1,12,16,12,0,40,16,12,16,16,60,100
2664,Sao Tome and Principe,SSA,c,2009,F,2,2,11,14,8,0,33,15,10,12,10,47,80
2665,Saudi Arabia,MENA,c,2009,NF,7,6,0,0,1,0,3,4,0,3,2,9,12
2666,Senegal,SSA,c,2009,PF,3,3,9,11,9,0,29,14,10,10,9,43,72
2667,Serbia,Europe,c,2009,F,3,2,9,13,7,0,29,14,11,9,13,47,76
2668,Seychelles,SSA,c,2009,PF,3,3,8,10,7,0,25,11,9,11,11,42,67
2669,Sierra Leone,SSA,c,2009,PF,3,3,10,12,5,0,27,12,8,8,9,37,64
2670,Singapore,Asia,c,2009,PF,5,4,4,6,7,0,17,9,3,7,12,31,48
2671,Slovakia,Europe,c,2009,F,1,1,12,15,10,0,37,16,12,12,14,54,91
2672,Slovenia,Europe,c,2009,F,1,1,12,15,11,0,38,14,12,14,13,53,91
2673,Solomon Islands,Asia,c,2009,PF,4,3,6,10,6,0,22,13,9,8,12,42,64
2674,Somalia,SSA,c,2009,NF,7,7,0,0,0,0,0,2,0,0,0,2,2
2675,Somaliland,SSA,t,2009,PF,5,4,5,7,5,0,17,8,6,7,6,27,44
2676,South Africa,SSA,c,2009,F,2,2,12,14,9,0,35,15,12,11,12,50,85
2677,South Korea,Asia,c,2009,F,1,2,11,15,10,0,36,14,11,13,12,50,86
2678,South Ossetia,Eurasia,t,2009,NF,7,6,1,0,0,3,-2,4,1,1,5,11,9
2679,Spain,Europe,c,2009,F,1,1,12,16,12,0,40,16,12,14,15,57,97
2680,Sri Lanka,Asia,c,2009,PF,4,4,8,7,6,0,21,8,8,6,9,31,52
2681,St. Kitts and Nevis,Americas,c,2009,F,1,1,12,16,11,0,39,15,12,12,14,53,92
2682,St. Lucia,Americas,c,2009,F,1,1,12,16,11,0,39,15,12,12,14,53,92
2683,St. Vincent and the Grenadines,Americas,c,2009,F,2,1,11,15,9,0,35,15,11,13,14,53,88
2684,Sudan,SSA,c,2009,NF,7,7,0,4,3,4,3,4,3,0,0,7,10
2685,Suriname,Americas,c,2009,F,2,2,12,13,8,0,33,15,11,9,10,45,78
2686,Swaziland,SSA,c,2009,NF,7,5,0,1,1,0,3,8,3,4,5,20,23
2687,Sweden,Europe,c,2009,F,1,1,12,16,12,0,40,16,12,16,16,60,100
2688,Switzerland,Europe,c,2009,F,1,1,12,15,12,0,39,16,12,15,15,58,97
2689,Syria,MENA,c,2009,NF,7,6,0,0,1,0,1,2,0,1,5,8,9
2690,Taiwan,Asia,c,2009,F,2,1,11,15,9,0,35,16,10,15,13,54,89
2691,Tajikistan,Eurasia,c,2009,NF,6,5,2,4,2,0,8,6,4,4,5,19,27
2692,Tanzania,SSA,c,2009,PF,4,3,6,10,6,0,22,11,7,10,8,36,58
2693,Thailand,Asia,c,2009,PF,5,4,3,5,4,0,12,9,6,6,11,32,44
2694,The Gambia,SSA,c,2009,PF,5,4,6,7,3,0,16,8,6,6,7,27,43
2695,Tibet,Asia,t,2009,NF,7,7,0,0,1,3,-2,0,0,0,3,3,1
2696,Timor-Leste,Asia,c,2009,PF,3,4,11,11,6,0,28,12,7,6,9,34,62
2697,Togo,SSA,c,2009,PF,5,5,4,7,3,0,14,8,6,5,6,25,39
2698,Tonga,Asia,c,2009,PF,5,3,3,9,3,0,15,12,5,11,12,40,55
2699,Transnistria,Eurasia,t,2009,NF,6,6,2,4,1,0,7,6,2,2,5,15,22
2700,Trinidad and Tobago,Americas,c,2009,F,2,2,11,12,9,0,32,15,11,10,13,49,81
2701,Tunisia,MENA,c,2009,NF,7,5,1,3,1,0,5,4,2,4,8,18,23
2702,Turkey,Europe,c,2009,PF,3,3,10,12,7,0,29,11,7,8,10,36,65
2703,Turkmenistan,Eurasia,c,2009,NF,7,7,0,1,0,0,1,2,0,1,2,5,6
2704,Tuvalu,Asia,c,2009,F,1,1,12,15,10,0,37,16,12,15,14,57,94
2705,Uganda,SSA,c,2009,PF,5,4,4,7,4,0,15,11,6,6,7,30,45
2706,Ukraine,Eurasia,c,2009,F,3,2,10,13,5,0,28,13,11,10,11,45,73
2707,United Arab Emirates,MENA,c,2009,NF,6,5,1,2,2,0,9,8,3,4,4,19,28
2708,United Kingdom,Europe,c,2009,F,1,1,12,16,12,0,40,16,12,14,15,57,97
2709,United States,Americas,c,2009,F,1,1,11,16,11,0,38,16,11,14,15,56,94
2710,Uruguay,Americas,c,2009,F,1,1,12,16,11,0,39,16,12,15,15,58,97
2711,Uzbekistan,Eurasia,c,2009,NF,7,7,0,0,0,0,0,1,0,0,2,3,3
2712,Vanuatu,Asia,c,2009,F,2,2,9,15,8,0,32,16,11,10,11,48,80
2713,Venezuela,Americas,c,2009,PF,4,4,7,8,3,0,18,9,6,5,8,28,46
2714,Vietnam,Asia,c,2009,NF,7,5,0,1,1,0,2,6,2,4,8,20,22
2715,Western Sahara,MENA,t,2009,NF,7,6,0,0,0,2,-2,3,3,0,5,11,9
2716,Yemen,MENA,c,2009,PF,5,5,5,7,3,0,15,7,4,4,5,20,35
2717,Zambia,SSA,c,2009,PF,3,3,8,12,6,0,26,11,8,9,7,35,61
2718,Zimbabwe,SSA,c,2009,NF,7,6,1,3,0,0,4,4,2,1,1,8,12
2719,Abkhazia,Eurasia,t,2008,PF,5,5,5,6,4,0,15,8,4,4,5,21,36
2720,Afghanistan,Asia,c,2008,PF,5,5,6,7,4,0,17,5,4,3,5,17,34
2721,Albania,Europe,c,2008,PF,3,3,8,11,7,0,26,12,8,10,9,39,65
2722,Algeria,MENA,c,2008,NF,6,5,4,4,3,0,11,7,6,5,7,25,36
2723,Andorra,Europe,c,2008,F,1,1,12,15,12,0,39,16,11,15,15,57,96
2724,Angola,SSA,c,2008,NF,6,5,2,5,1,0,8,8,6,4,3,21,29
2725,Antigua and Barbuda,Americas,c,2008,F,2,2,11,12,7,0,30,13,9,12,13,47,77
2726,Argentina,Americas,c,2008,F,2,2,11,15,6,0,32,14,11,10,13,48,80
2727,Armenia,Eurasia,c,2008,PF,5,4,5,5,4,0,14,8,5,6,9,28,42
2728,Australia,Asia,c,2008,F,1,1,12,15,12,0,39,16,12,14,15,57,96
2729,Austria,Europe,c,2008,F,1,1,12,16,12,0,40,16,12,15,15,58,98
2730,Azerbaijan,Eurasia,c,2008,NF,6,5,3,4,3,0,10,6,3,4,8,21,31
2731,Bahamas,Americas,c,2008,F,1,1,12,16,10,0,38,16,12,15,15,58,96
2732,Bahrain,MENA,c,2008,PF,5,5,3,8,4,0,15,9,3,3,7,22,37
2733,Bangladesh,Asia,c,2008,PF,5,4,3,5,4,0,12,7,6,6,9,28,40
2734,Barbados,Americas,c,2008,F,1,1,12,16,12,0,40,16,12,16,15,59,99
2735,Belarus,Eurasia,c,2008,NF,7,6,0,2,1,0,3,3,0,2,5,10,13
2736,Belgium,Europe,c,2008,F,1,1,12,16,11,0,39,16,12,15,15,58,97
2737,Belize,Americas,c,2008,F,1,2,12,14,10,0,36,15,11,12,13,51,87
2738,Benin,SSA,c,2008,F,2,2,10,15,8,0,33,15,12,12,10,49,82
2739,Bhutan,Asia,c,2008,NF,6,5,3,4,5,1,11,7,3,5,8,23,34
2740,Bolivia,Americas,c,2008,PF,3,3,11,13,5,0,29,15,10,7,9,41,70
2741,Bosnia and Herzegovina,Europe,c,2008,PF,4,3,8,10,5,0,23,11,8,10,10,39,62
2742,Botswana,SSA,c,2008,F,2,2,11,11,9,0,31,14,10,13,11,48,79
2743,Brazil,Americas,c,2008,F,2,2,11,14,6,0,31,15,10,8,12,45,76
2744,Brunei,Asia,c,2008,NF,6,5,0,3,3,0,7,6,3,6,8,23,30
2745,Bulgaria,Europe,c,2008,F,1,2,12,15,9,0,36,14,11,12,12,49,85
2746,Burkina Faso,SSA,c,2008,PF,5,3,5,8,4,0,17,13,9,6,8,36,53
2747,Burundi,SSA,c,2008,PF,4,5,9,9,4,0,22,8,5,4,6,23,45
2748,Cambodia,Asia,c,2008,NF,6,5,3,5,3,0,11,10,6,2,6,24,35
2749,Cameroon,SSA,c,2008,NF,6,6,2,4,3,0,9,7,3,2,4,16,25
2750,Canada,Americas,c,2008,F,1,1,12,16,12,0,40,16,12,15,16,59,99
2751,Cape Verde,SSA,c,2008,F,1,1,12,15,10,0,37,15,11,14,13,53,90
2752,Central African Republic,SSA,c,2008,PF,5,5,7,7,3,0,17,10,6,3,4,23,40
2753,Chad,SSA,c,2008,NF,7,6,3,1,1,0,5,7,4,1,3,15,20
2754,Chechnya,Eurasia,t,2008,NF,7,7,0,0,0,0,0,4,0,0,3,7,7
2755,Chile,Americas,c,2008,F,1,1,12,15,12,0,39,16,12,15,15,58,97
2756,China,Asia,c,2008,NF,7,6,0,1,1,0,2,4,2,2,8,16,18
2757,Colombia,Americas,c,2008,PF,3,3,10,9,7,0,26,12,6,7,10,35,61
2758,Comoros,SSA,c,2008,PF,4,4,8,11,4,0,23,10,6,8,6,30,53
2759,Congo (Brazzaville),SSA,c,2008,NF,6,5,1,4,3,0,8,9,7,2,6,24,32
2760,Congo (Kinshasa),SSA,c,2008,NF,5,6,6,5,2,0,13,6,5,0,1,12,25
2761,Costa Rica,Americas,c,2008,F,1,1,12,15,11,0,38,16,11,13,13,53,91
2762,Cote d'Ivoire,SSA,c,2008,NF,7,5,1,2,2,0,5,5,4,5,5,19,24
2763,Croatia,Europe,c,2008,F,2,2,12,14,9,0,35,14,12,11,13,50,85
2764,Cuba,Americas,c,2008,NF,7,7,0,0,1,0,1,2,1,1,2,6,7
2765,Cyprus,Europe,c,2008,F,1,1,11,16,11,0,38,15,12,15,15,57,95
2766,Czech Republic,Europe,c,2008,F,1,1,12,15,11,0,38,16,12,14,15,57,95
2767,Denmark,Europe,c,2008,F,1,1,12,16,12,0,40,16,12,15,15,58,98
2768,Djibouti,SSA,c,2008,PF,5,5,4,5,3,0,12,6,5,5,6,22,34
2769,Dominica,Americas,c,2008,F,1,1,12,16,11,0,39,16,12,15,15,58,97
2770,Dominican Republic,Americas,c,2008,F,2,2,11,13,9,0,33,15,11,10,11,47,80
2771,Ecuador,Americas,c,2008,PF,3,3,9,14,4,0,27,15,11,6,10,42,69
2772,Egypt,MENA,c,2008,NF,6,5,1,4,2,0,7,5,2,4,7,18,25
2773,El Salvador,Americas,c,2008,F,2,3,12,13,8,0,33,15,8,7,10,40,73
2774,Equatorial Guinea,SSA,c,2008,NF,7,6,0,1,0,0,1,5,0,1,3,9,10
2775,Eritrea,SSA,c,2008,NF,7,6,0,1,2,0,3,2,0,2,6,10,13
2776,Estonia,Europe,c,2008,F,1,1,12,14,12,0,38,16,12,14,14,56,94
2777,Ethiopia,SSA,c,2008,PF,5,5,5,4,4,0,13,7,3,4,6,20,33
2778,Fiji,Asia,c,2008,PF,6,4,0,5,2,0,7,11,4,7,10,32,39
2779,Finland,Europe,c,2008,F,1,1,12,16,12,0,40,16,12,16,16,60,100
2780,France,Europe,c,2008,F,1,1,12,15,11,0,38,15,12,13,15,55,93
2781,Gabon,SSA,c,2008,PF,6,4,2,5,3,0,10,10,6,6,5,27,37
2782,Georgia,Eurasia,c,2008,PF,4,4,8,6,6,0,20,11,7,6,10,34,54
2783,Germany,Europe,c,2008,F,1,1,12,15,12,0,39,15,12,15,15,57,96
2784,Ghana,SSA,c,2008,F,1,2,12,15,10,0,37,14,11,12,10,47,84
2785,Greece,Europe,c,2008,F,1,2,12,15,10,0,37,15,11,13,13,52,89
2786,Grenada,Americas,c,2008,F,1,2,12,16,9,0,37,15,9,12,15,51,88
2787,Guatemala,Americas,c,2008,PF,3,4,9,10,5,0,24,12,8,5,8,33,57
2788,Guinea,SSA,c,2008,NF,6,5,2,5,3,0,10,8,5,4,6,23,33
2789,Guinea-Bissau,SSA,c,2008,PF,4,4,9,9,3,0,21,10,8,6,6,30,51
2790,Guyana,Americas,c,2008,F,2,3,11,13,7,0,31,15,10,8,9,42,73
2791,Haiti,Americas,c,2008,PF,4,5,7,10,5,0,22,10,6,4,5,25,47
2792,Honduras,Americas,c,2008,PF,3,3,9,10,6,0,25,12,8,7,9,36,61
2793,Hong Kong,Asia,t,2008,PF,5,2,3,7,6,0,16,14,10,14,13,51,67
2794,Hungary,Europe,c,2008,F,1,1,12,15,10,0,37,16,12,13,14,55,92
2795,Iceland,Europe,c,2008,F,1,1,12,16,12,0,40,16,12,16,16,60,100
2796,India,Asia,c,2008,F,2,3,11,14,9,0,34,13,10,9,10,42,76
2797,Indian Kashmir,Asia,t,2008,PF,5,4,6,6,3,0,15,8,6,4,8,26,41
2798,Indonesia,Asia,c,2008,F,2,3,11,13,6,0,30,12,9,7,9,37,67
2799,Iran,MENA,c,2008,NF,6,6,3,4,3,0,10,5,2,3,4,14,24
2800,Iraq,MENA,c,2008,NF,6,6,7,6,1,3,11,5,3,0,4,12,23
2801,Ireland,Europe,c,2008,F,1,1,12,16,11,0,39,16,12,15,15,58,97
2802,Israel,MENA,c,2008,F,1,2,12,15,10,0,37,14,12,10,11,47,84
2803,Israeli Occupied Territories,MENA,t,2008,NF,6,6,3,2,3,1,7,6,5,1,4,16,23
2804,Italy,Europe,c,2008,F,1,1,12,15,11,0,38,15,12,12,15,54,92
2805,Jamaica,Americas,c,2008,F,2,3,12,14,8,0,34,15,9,8,11,43,77
2806,Japan,Asia,c,2008,F,1,2,12,15,10,0,37,13,10,15,13,51,88
2807,Jordan,MENA,c,2008,PF,5,4,2,6,5,0,13,9,5,6,8,28,41
2808,Kazakhstan,Eurasia,c,2008,NF,6,5,3,3,2,0,8,7,4,4,7,22,30
2809,Kenya,SSA,c,2008,PF,4,3,6,9,5,0,20,14,9,7,8,38,58
2810,Kiribati,Asia,c,2008,F,1,1,12,16,8,0,36,15,12,15,13,55,91
2811,Kosovo,Europe,t,2008,NF,6,5,6,5,3,3,11,7,6,4,6,23,34
2812,Kuwait,MENA,c,2008,PF,4,4,4,9,6,0,19,9,6,7,5,27,46
2813,Kyrgyzstan,Eurasia,c,2008,PF,5,4,5,7,4,0,16,10,7,5,7,29,45
2814,Laos,Asia,c,2008,NF,7,6,0,1,0,0,1,4,1,2,5,12,13
2815,Latvia,Europe,c,2008,F,2,1,12,15,8,0,35,16,12,12,13,53,88
2816,Lebanon,MENA,c,2008,PF,5,4,4,7,4,0,15,12,8,5,9,34,49
2817,Lesotho,SSA,c,2008,F,2,3,9,12,9,0,30,14,7,11,9,41,71
2818,Liberia,SSA,c,2008,PF,3,4,9,10,6,0,25,11,8,7,8,34,59
2819,Libya,MENA,c,2008,NF,7,7,0,1,0,0,1,1,0,0,6,7,8
2820,Liechtenstein,Europe,c,2008,F,1,1,12,16,12,0,40,16,12,16,16,60,100
2821,Lithuania,Europe,c,2008,F,1,1,12,15,9,0,36,16,11,14,13,54,90
2822,Luxembourg,Europe,c,2008,F,1,1,12,16,12,0,40,16,12,16,16,60,100
2823,Macedonia,Europe,c,2008,PF,3,3,7,10,7,0,24,11,7,8,10,36,60
2824,Madagascar,SSA,c,2008,PF,4,3,7,8,7,0,22,10,8,9,9,36,58
2825,Malawi,SSA,c,2008,PF,4,4,7,10,6,0,23,11,8,8,7,34,57
2826,Malaysia,Asia,c,2008,PF,4,4,6,7,6,0,19,8,5,6,8,27,46
2827,Maldives,Asia,c,2008,NF,6,5,3,4,4,0,11,7,4,7,7,25,36
2828,Mali,SSA,c,2008,F,2,3,9,12,9,0,30,15,9,9,9,42,72
2829,Malta,Europe,c,2008,F,1,1,12,16,11,0,39,16,12,15,15,58,97
2830,Marshall Islands,Asia,c,2008,F,1,1,12,15,10,0,37,16,11,15,13,55,92
2831,Mauritania,SSA,c,2008,PF,4,4,9,7,6,0,22,10,8,6,6,30,52
2832,Mauritius,SSA,c,2008,F,1,2,12,15,11,0,38,15,12,13,12,52,90
2833,Mexico,Americas,c,2008,F,2,3,10,14,8,0,32,14,9,7,11,41,73
2834,Micronesia,Asia,c,2008,F,1,1,12,15,10,0,37,16,11,15,14,56,93
2835,Moldova,Eurasia,c,2008,PF,3,4,9,8,7,0,24,10,6,8,9,33,57
2836,Monaco,Europe,c,2008,F,2,1,10,11,10,0,31,15,12,15,14,56,87
2837,Mongolia,Asia,c,2008,F,2,2,8,15,10,0,33,15,10,12,12,49,82
2838,Montenegro,Europe,c,2008,PF,3,3,9,9,6,0,24,12,10,8,11,41,65
2839,Morocco,MENA,c,2008,PF,5,4,4,7,5,0,16,8,6,6,8,28,44
2840,Mozambique,SSA,c,2008,PF,3,3,7,11,7,0,25,12,7,7,9,35,60
2841,Myanmar,Asia,c,2008,NF,7,7,0,1,0,3,-2,2,0,0,3,5,3
2842,Nagorno-Karabakh,Eurasia,t,2008,PF,5,5,6,5,3,0,14,7,3,5,5,20,34
2843,Namibia,SSA,c,2008,F,2,2,10,12,9,0,31,15,12,10,9,46,77
2844,Nauru,Asia,c,2008,F,1,1,12,16,10,0,38,15,11,15,14,55,93
2845,Nepal,Asia,c,2008,PF,5,4,4,9,4,0,17,10,6,6,7,29,46
2846,Netherlands,Europe,c,2008,F,1,1,12,16,12,0,40,16,12,15,16,59,99
2847,New Zealand,Asia,c,2008,F,1,1,12,15,12,0,39,16,11,15,15,57,96
2848,Nicaragua,Americas,c,2008,PF,3,3,11,12,4,0,27,14,7,7,9,37,64
2849,Niger,SSA,c,2008,PF,3,4,11,9,8,0,28,10,8,8,6,32,60
2850,Nigeria,SSA,c,2008,PF,4,4,3,9,6,0,18,11,8,5,7,31,49
2851,North Korea,Asia,c,2008,NF,7,7,0,0,0,0,0,0,0,0,2,2,2
2852,Northern Cyprus,Europe,t,2008,F,2,2,11,14,9,0,34,13,9,12,12,46,80
2853,Norway,Europe,c,2008,F,1,1,12,16,12,0,40,16,12,16,16,60,100
2854,Oman,MENA,c,2008,NF,6,5,2,2,2,0,10,6,3,4,5,18,28
2855,Pakistan,Asia,c,2008,NF,6,5,2,4,2,0,8,5,4,3,6,18,26
2856,Pakistani Kashmir,Asia,t,2008,NF,7,5,1,3,1,2,3,6,4,4,6,20,23
2857,Palau,Asia,c,2008,F,1,1,12,15,10,0,37,16,11,15,13,55,92
2858,Palestinian Authority Administered Territories,MENA,t,2008,NF,5,6,4,7,2,0,13,5,4,1,4,14,27
2859,Panama,Americas,c,2008,F,1,2,12,15,9,0,36,15,11,9,12,47,83
2860,Papua New Guinea,Asia,c,2008,PF,3,3,9,11,4,0,24,12,9,7,8,36,60
2861,Paraguay,Americas,c,2008,PF,3,3,11,11,4,0,26,12,8,6,10,36,62
2862,Peru,Americas,c,2008,F,2,3,11,14,7,0,32,15,8,8,10,41,73
2863,Philippines,Asia,c,2008,PF,4,3,6,10,7,0,23,14,8,6,10,38,61
2864,Poland,Europe,c,2008,F,1,1,12,16,10,0,38,16,12,13,14,55,93
2865,Portugal,Europe,c,2008,F,1,1,12,16,12,0,40,16,12,15,15,58,98
2866,Puerto Rico,Americas,t,2008,F,1,1,12,15,10,0,37,16,11,14,14,55,92
2867,Qatar,MENA,c,2008,NF,6,5,2,2,3,0,10,8,2,4,4,18,28
2868,Romania,Europe,c,2008,F,2,2,11,14,7,0,32,14,11,12,12,49,81
2869,Russia,Eurasia,c,2008,NF,6,5,3,3,3,0,9,8,4,4,7,23,32
2870,Rwanda,SSA,c,2008,NF,6,5,3,4,4,0,11,7,3,6,7,23,34
2871,Samoa,Asia,c,2008,F,2,2,9,13,10,0,32,14,10,13,12,49,81
2872,San Marino,Europe,c,2008,F,1,1,12,16,12,0,40,16,12,16,16,60,100
2873,Sao Tome and Principe,SSA,c,2008,F,2,2,11,14,8,0,33,15,10,12,10,47,80
2874,Saudi Arabia,MENA,c,2008,NF,7,6,0,0,1,0,4,4,0,3,2,9,13
2875,Senegal,SSA,c,2008,F,2,3,9,12,9,0,30,14,10,10,9,43,73
2876,Serbia,Europe,c,2008,F,3,2,9,13,7,0,29,14,11,9,13,47,76
2877,Seychelles,SSA,c,2008,PF,3,3,8,10,7,0,25,9,9,11,11,40,65
2878,Sierra Leone,SSA,c,2008,PF,3,3,10,12,4,0,26,12,8,8,9,37,63
2879,Singapore,Asia,c,2008,PF,5,4,4,6,7,0,17,9,3,8,12,32,49
2880,Slovakia,Europe,c,2008,F,1,1,12,15,10,0,37,16,12,12,14,54,91
2881,Slovenia,Europe,c,2008,F,1,1,12,15,11,0,38,15,12,14,12,53,91
2882,Solomon Islands,Asia,c,2008,PF,4,3,6,10,5,0,21,13,9,8,12,42,63
2883,Somalia,SSA,c,2008,NF,7,7,0,0,0,0,0,3,0,0,0,3,3
2884,South Africa,SSA,c,2008,F,2,2,12,14,9,0,35,15,12,12,12,51,86
2885,South Korea,Asia,c,2008,F,1,2,11,15,10,0,36,14,11,13,12,50,86
2886,Spain,Europe,c,2008,F,1,1,12,15,12,0,39,16,12,14,15,57,96
2887,Sri Lanka,Asia,c,2008,PF,4,4,8,7,6,0,21,8,8,6,9,31,52
2888,St. Kitts and Nevis,Americas,c,2008,F,1,1,12,16,11,0,39,15,12,12,14,53,92
2889,St. Lucia,Americas,c,2008,F,1,1,12,16,11,0,39,15,12,12,14,53,92
2890,St. Vincent and the Grenadines,Americas,c,2008,F,2,1,11,15,9,0,35,15,11,13,14,53,88
2891,Sudan,SSA,c,2008,NF,7,7,0,4,3,4,3,4,3,0,0,7,10
2892,Suriname,Americas,c,2008,F,2,2,12,13,8,0,33,15,11,9,10,45,78
2893,Swaziland,SSA,c,2008,NF,7,5,0,1,1,0,3,8,3,4,5,20,23
2894,Sweden,Europe,c,2008,F,1,1,12,16,12,0,40,16,12,16,16,60,100
2895,Switzerland,Europe,c,2008,F,1,1,12,15,12,0,39,16,12,15,15,58,97
2896,Syria,MENA,c,2008,NF,7,6,0,0,1,0,1,2,0,1,5,8,9
2897,Taiwan,Asia,c,2008,F,2,1,10,15,9,0,34,16,11,15,13,55,89
2898,Tajikistan,Eurasia,c,2008,NF,6,5,2,4,3,0,9,6,4,4,5,19,28
2899,Tanzania,SSA,c,2008,PF,4,3,6,10,6,0,22,11,7,10,8,36,58
2900,Thailand,Asia,c,2008,PF,6,4,1,4,3,0,8,9,5,6,11,31,39
2901,The Gambia,SSA,c,2008,PF,5,4,6,7,4,0,17,10,6,7,8,31,48
2902,Tibet,Asia,t,2008,NF,7,7,0,0,1,3,-2,0,0,0,4,4,2
2903,Timor-Leste,Asia,c,2008,PF,3,4,11,11,6,0,28,12,7,6,9,34,62
2904,Togo,SSA,c,2008,PF,5,5,4,7,3,0,14,8,6,4,6,24,38
2905,Tonga,Asia,c,2008,PF,5,3,3,9,3,0,15,12,5,11,12,40,55
2906,Transnistria,Eurasia,t,2008,NF,6,6,2,4,1,0,7,6,2,2,5,15,22
2907,Trinidad and Tobago,Americas,c,2008,F,2,2,11,12,9,0,32,15,11,10,13,49,81
2908,Tunisia,MENA,c,2008,NF,7,5,1,3,1,0,5,4,2,4,8,18,23
2909,Turkey,Europe,c,2008,PF,3,3,10,12,7,0,29,12,7,8,10,37,66
2910,Turkmenistan,Eurasia,c,2008,NF,7,7,0,0,0,0,0,2,0,1,2,5,5
2911,Tuvalu,Asia,c,2008,F,1,1,12,15,10,0,37,16,12,15,14,57,94
2912,Uganda,SSA,c,2008,PF,5,4,4,7,4,0,15,11,6,6,7,30,45
2913,Ukraine,Eurasia,c,2008,F,3,2,10,13,6,0,29,13,10,10,11,44,73
2914,United Arab Emirates,MENA,c,2008,NF,6,5,1,2,2,0,9,7,3,3,4,17,26
2915,United Kingdom,Europe,c,2008,F,1,1,12,16,12,0,40,16,12,14,15,57,97
2916,United States,Americas,c,2008,F,1,1,11,16,11,0,38,16,11,14,15,56,94
2917,Uruguay,Americas,c,2008,F,1,1,12,16,11,0,39,16,12,15,15,58,97
2918,Uzbekistan,Eurasia,c,2008,NF,7,7,0,0,0,0,0,1,0,0,2,3,3
2919,Vanuatu,Asia,c,2008,F,2,2,9,15,8,0,32,16,11,10,11,48,80
2920,Venezuela,Americas,c,2008,PF,4,4,8,8,3,0,19,9,6,5,8,28,47
2921,Vietnam,Asia,c,2008,NF,7,5,0,1,1,0,2,5,2,4,8,19,21
2922,Western Sahara,MENA,t,2008,NF,7,6,0,0,0,2,-2,3,3,0,5,11,9
2923,Yemen,MENA,c,2008,PF,5,5,4,7,3,0,14,7,4,4,5,20,34
2924,Zambia,SSA,c,2008,PF,3,4,8,12,6,0,26,11,8,8,7,34,60
2925,Zimbabwe,SSA,c,2008,NF,7,6,1,4,0,0,5,5,2,1,1,9,14
2926,Abkhazia,Eurasia,t,2007,PF,5,5,5,5,3,0,13,8,4,4,5,21,34
2927,Afghanistan,Asia,c,2007,PF,5,5,6,7,4,0,17,5,5,3,5,18,35
2928,Albania,Europe,c,2007,PF,3,3,8,11,7,0,26,11,8,10,9,38,64
2929,Algeria,MENA,c,2007,NF,6,5,4,4,3,0,11,7,6,5,7,25,36
2930,Andorra,Europe,c,2007,F,1,1,12,15,12,0,39,16,11,15,15,57,96
2931,Angola,SSA,c,2007,NF,6,5,2,5,1,0,8,8,6,4,3,21,29
2932,Antigua and Barbuda,Americas,c,2007,F,2,2,11,12,7,0,30,13,9,12,13,47,77
2933,Argentina,Americas,c,2007,F,2,2,11,15,7,0,33,14,11,10,13,48,81
2934,Armenia,Eurasia,c,2007,PF,5,4,4,5,4,0,13,8,5,6,9,28,41
2935,Australia,Asia,c,2007,F,1,1,12,15,12,0,39,16,12,14,15,57,96
2936,Austria,Europe,c,2007,F,1,1,12,16,12,0,40,16,12,15,15,58,98
2937,Azerbaijan,Eurasia,c,2007,NF,6,5,3,4,3,0,10,7,3,4,8,22,32
2938,Bahamas,Americas,c,2007,F,1,1,12,16,10,0,38,16,12,15,15,58,96
2939,Bahrain,MENA,c,2007,PF,5,5,3,9,4,0,16,8,3,4,5,20,36
2940,Bangladesh,Asia,c,2007,PF,4,4,8,10,4,0,22,8,8,6,9,31,53
2941,Barbados,Americas,c,2007,F,1,1,12,16,12,0,40,16,12,16,15,59,99
2942,Belarus,Eurasia,c,2007,NF,7,6,0,3,1,0,4,3,0,2,5,10,14
2943,Belgium,Europe,c,2007,F,1,1,12,16,12,0,40,16,12,15,15,58,98
2944,Belize,Americas,c,2007,F,1,2,12,14,10,0,36,15,11,12,13,51,87
2945,Benin,SSA,c,2007,F,2,2,10,15,8,0,33,15,12,12,10,49,82
2946,Bhutan,Asia,c,2007,NF,6,5,3,1,5,1,10,7,2,4,8,21,31
2947,Bolivia,Americas,c,2007,PF,3,3,11,13,4,0,28,15,11,8,9,43,71
2948,Bosnia and Herzegovina,Europe,c,2007,PF,3,3,8,11,6,0,25,11,8,10,10,39,64
2949,Botswana,SSA,c,2007,F,2,2,11,11,9,0,31,14,10,13,10,47,78
2950,Brazil,Americas,c,2007,F,2,2,11,14,6,0,31,15,10,8,12,45,76
2951,Brunei,Asia,c,2007,NF,6,5,0,3,3,0,7,6,3,6,8,23,30
2952,Bulgaria,Europe,c,2007,F,1,2,12,15,9,0,36,14,11,12,12,49,85
2953,Burkina Faso,SSA,c,2007,PF,5,3,5,8,4,0,17,14,9,6,8,37,54
2954,Burundi,SSA,c,2007,PF,4,5,9,9,4,0,22,8,5,4,6,23,45
2955,Cambodia,Asia,c,2007,NF,6,5,3,5,3,0,11,9,6,2,7,24,35
2956,Cameroon,SSA,c,2007,NF,6,6,3,5,3,0,11,7,3,2,4,16,27
2957,Canada,Americas,c,2007,F,1,1,12,16,12,0,40,16,12,15,16,59,99
2958,Cape Verde,SSA,c,2007,F,1,1,12,15,10,0,37,15,11,14,13,53,90
2959,Central African Republic,SSA,c,2007,PF,5,4,7,7,3,0,17,10,9,3,4,26,43
2960,Chad,SSA,c,2007,NF,6,6,3,1,2,0,6,7,5,1,3,16,22
2961,Chechnya,Eurasia,t,2007,NF,7,7,0,0,0,0,0,4,0,0,2,6,6
2962,Chile,Americas,c,2007,F,1,1,12,15,12,0,39,16,12,15,15,58,97
2963,China,Asia,c,2007,NF,7,6,0,1,1,0,2,4,2,2,7,15,17
2964,Colombia,Americas,c,2007,PF,3,3,10,9,7,0,26,12,7,7,10,36,62
2965,Comoros,SSA,c,2007,PF,3,4,9,11,4,0,24,10,6,8,6,30,54
2966,Congo (Brazzaville),SSA,c,2007,NF,6,5,3,5,3,0,11,9,7,2,6,24,35
2967,Congo (Kinshasa),SSA,c,2007,NF,5,6,6,6,2,0,14,6,5,0,1,12,26
2968,Costa Rica,Americas,c,2007,F,1,1,12,15,11,0,38,16,11,13,13,53,91
2969,Cote d'Ivoire,SSA,c,2007,NF,7,6,1,2,2,0,5,5,4,3,4,16,21
2970,Croatia,Europe,c,2007,F,2,2,12,14,9,0,35,14,12,11,13,50,85
2971,Cuba,Americas,c,2007,NF,7,7,0,0,1,0,1,2,1,1,2,6,7
2972,Cyprus,Europe,c,2007,F,1,1,11,16,11,0,38,15,12,15,15,57,95
2973,Czech Republic,Europe,c,2007,F,1,1,12,15,11,0,38,16,12,14,15,57,95
2974,Denmark,Europe,c,2007,F,1,1,12,16,12,0,40,16,12,15,15,58,98
2975,Djibouti,SSA,c,2007,PF,5,5,4,5,3,0,12,7,5,5,6,23,35
2976,Dominica,Americas,c,2007,F,1,1,12,16,10,0,38,16,12,13,13,54,92
2977,Dominican Republic,Americas,c,2007,F,2,2,11,13,9,0,33,15,11,10,11,47,80
2978,Ecuador,Americas,c,2007,PF,3,3,9,15,4,0,28,15,11,5,10,41,69
2979,Egypt,MENA,c,2007,NF,6,5,1,4,2,0,7,6,2,5,7,20,27
2980,El Salvador,Americas,c,2007,F,2,3,12,13,8,0,33,15,9,7,10,41,74
2981,Equatorial Guinea,SSA,c,2007,NF,7,6,0,1,0,0,1,5,0,1,3,9,10
2982,Eritrea,SSA,c,2007,NF,7,6,0,1,2,0,3,2,0,2,6,10,13
2983,Estonia,Europe,c,2007,F,1,1,12,15,12,0,39,16,12,14,14,56,95
2984,Ethiopia,SSA,c,2007,PF,5,5,5,5,4,0,14,7,3,4,6,20,34
2985,Fiji,Asia,c,2007,PF,6,4,0,5,2,0,7,10,4,7,10,31,38
2986,Finland,Europe,c,2007,F,1,1,12,16,12,0,40,16,12,16,16,60,100
2987,France,Europe,c,2007,F,1,1,12,15,11,0,38,15,12,14,15,56,94
2988,Gabon,SSA,c,2007,PF,6,4,2,5,3,0,10,10,6,6,5,27,37
2989,Georgia,Eurasia,c,2007,PF,3,3,9,9,7,0,25,12,8,7,10,37,62
2990,Germany,Europe,c,2007,F,1,1,12,15,12,0,39,15,12,15,15,57,96
2991,Ghana,SSA,c,2007,F,1,2,12,15,10,0,37,14,11,12,10,47,84
2992,Greece,Europe,c,2007,F,1,2,12,15,10,0,37,15,10,14,13,52,89
2993,Grenada,Americas,c,2007,F,1,2,12,16,9,0,37,15,9,11,14,49,86
2994,Guatemala,Americas,c,2007,PF,3,4,9,10,5,0,24,12,8,5,8,33,57
2995,Guinea,SSA,c,2007,NF,6,5,2,5,2,0,9,8,5,4,6,23,32
2996,Guinea-Bissau,SSA,c,2007,PF,4,4,9,9,4,0,22,11,8,8,6,33,55
2997,Guyana,Americas,c,2007,F,2,3,11,13,7,0,31,15,10,8,9,42,73
2998,Haiti,Americas,c,2007,PF,4,5,7,10,3,0,20,10,5,2,5,22,42
2999,Honduras,Americas,c,2007,PF,3,3,9,10,6,0,25,13,8,7,9,37,62
3000,Hong Kong,Asia,t,2007,PF,5,2,3,7,6,0,16,14,10,14,13,51,67
3001,Hungary,Europe,c,2007,F,1,1,12,15,10,0,37,16,12,13,14,55,92
3002,Iceland,Europe,c,2007,F,1,1,12,16,12,0,40,16,12,16,16,60,100
3003,India,Asia,c,2007,F,2,3,11,14,9,0,34,13,10,9,10,42,76
3004,Indian Kashmir,Asia,t,2007,PF,5,5,6,6,3,0,15,8,6,3,8,25,40
3005,Indonesia,Asia,c,2007,F,2,3,11,13,6,0,30,10,9,7,9,35,65
3006,Iran,MENA,c,2007,NF,6,6,3,4,3,0,10,4,2,3,4,13,23
3007,Iraq,MENA,c,2007,NF,6,6,7,6,1,3,11,4,3,0,4,11,22
3008,Ireland,Europe,c,2007,F,1,1,12,16,11,0,39,16,12,15,15,58,97
3009,Israel,MENA,c,2007,F,1,2,12,15,10,0,37,14,12,10,11,47,84
3010,Israeli Occupied Territories,MENA,t,2007,NF,6,5,3,3,3,1,8,6,5,1,5,17,25
3011,Italy,Europe,c,2007,F,1,1,12,15,11,0,38,15,12,12,15,54,92
3012,Jamaica,Americas,c,2007,F,2,3,10,13,8,0,31,15,9,8,11,43,74
3013,Japan,Asia,c,2007,F,1,2,12,15,10,0,37,13,10,15,13,51,88
3014,Jordan,MENA,c,2007,PF,5,4,3,6,5,0,14,9,5,6,8,28,42
3015,Kazakhstan,Eurasia,c,2007,NF,6,5,3,4,3,0,10,7,4,4,7,22,32
3016,Kenya,SSA,c,2007,PF,3,3,9,11,5,0,25,14,9,8,8,39,64
3017,Kiribati,Asia,c,2007,F,1,1,12,16,8,0,36,15,12,15,13,55,91
3018,Kosovo,Eurasia,t,2007,PF,6,5,6,5,3,0,11,7,6,4,7,18,29
3019,Kuwait,MENA,c,2007,PF,4,4,4,9,6,0,19,9,6,7,5,27,46
3020,Kyrgyzstan,Eurasia,c,2007,PF,5,4,5,7,4,0,16,10,8,5,7,30,46
3021,Laos,Asia,c,2007,NF,7,6,0,1,0,0,1,4,1,2,5,12,13
3022,Latvia,Europe,c,2007,F,1,1,12,15,9,0,36,16,12,12,13,53,89
3023,Lebanon,MENA,c,2007,PF,5,4,4,8,5,0,17,12,8,5,9,34,51
3024,Lesotho,SSA,c,2007,F,2,3,9,12,9,0,30,15,8,11,9,43,73
3025,Liberia,SSA,c,2007,PF,3,4,9,10,5,0,24,11,7,7,8,33,57
3026,Libya,MENA,c,2007,NF,7,7,0,1,0,0,1,1,0,0,6,7,8
3027,Liechtenstein,Europe,c,2007,F,1,1,12,16,12,0,40,16,12,16,16,60,100
3028,Lithuania,Europe,c,2007,F,1,1,12,15,9,0,36,16,11,14,13,54,90
3029,Luxembourg,Europe,c,2007,F,1,1,12,16,12,0,40,16,12,16,16,60,100
3030,Macedonia,Europe,c,2007,PF,3,3,7,10,7,0,24,11,7,8,10,36,60
3031,Madagascar,SSA,c,2007,PF,4,3,7,9,7,0,23,10,8,9,9,36,59
3032,Malawi,SSA,c,2007,PF,4,3,7,10,6,0,23,11,8,9,7,35,58
3033,Malaysia,Asia,c,2007,PF,4,4,6,7,6,0,19,8,6,6,9,29,48
3034,Maldives,Asia,c,2007,NF,6,5,3,4,4,0,11,6,3,7,7,23,34
3035,Mali,SSA,c,2007,F,2,2,9,12,9,0,30,16,9,10,9,44,74
3036,Malta,Europe,c,2007,F,1,1,12,16,11,0,39,16,12,16,15,59,98
3037,Marshall Islands,Asia,c,2007,F,1,1,12,15,10,0,37,16,11,15,13,55,92
3038,Mauritania,SSA,c,2007,PF,5,4,6,7,4,0,17,10,8,6,5,29,46
3039,Mauritius,SSA,c,2007,F,1,2,11,15,11,0,37,15,12,13,12,52,89
3040,Mexico,Americas,c,2007,F,2,3,10,14,9,0,33,14,10,8,11,43,76
3041,Micronesia,Asia,c,2007,F,1,1,12,15,10,0,37,16,11,15,14,56,93
3042,Moldova,Eurasia,c,2007,PF,3,4,9,8,7,0,24,10,6,8,9,33,57
3043,Monaco,Europe,c,2007,F,2,1,10,11,10,0,31,15,12,15,14,56,87
3044,Mongolia,Asia,c,2007,F,2,2,8,15,10,0,33,15,10,12,12,49,82
3045,Montenegro,Europe,c,2007,PF,3,3,9,9,6,0,24,12,10,8,11,41,65
3046,Morocco,MENA,c,2007,PF,5,4,4,7,6,0,17,8,6,6,8,28,45
3047,Mozambique,SSA,c,2007,PF,3,4,7,11,7,0,25,11,7,7,8,33,58
3048,Myanmar,Asia,c,2007,NF,7,7,0,1,0,3,-2,2,0,0,4,6,4
3049,Nagorno-Karabakh,Eurasia,t,2007,PF,5,5,6,5,3,0,14,8,4,4,5,21,35
3050,Namibia,SSA,c,2007,F,2,2,10,12,9,0,31,15,12,10,9,46,77
3051,Nauru,Asia,c,2007,F,1,1,12,16,10,0,38,15,11,15,14,55,93
3052,Nepal,Asia,c,2007,PF,5,4,4,9,4,0,17,9,6,6,7,28,45
3053,Netherlands,Europe,c,2007,F,1,1,12,16,12,0,40,16,12,15,16,59,99
3054,New Zealand,Asia,c,2007,F,1,1,12,15,12,0,39,16,11,15,15,57,96
3055,Nicaragua,Americas,c,2007,PF,3,3,11,12,5,0,28,14,8,7,10,39,67
3056,Niger,SSA,c,2007,PF,3,3,11,10,8,0,29,11,9,9,6,35,64
3057,Nigeria,SSA,c,2007,PF,4,4,6,9,6,0,21,11,7,5,7,30,51
3058,North Korea,Asia,c,2007,NF,7,7,0,0,0,0,0,0,0,0,1,1,1
3059,Northern Cyprus,Europe,t,2007,F,2,2,11,14,9,0,34,13,9,12,12,46,80
3060,Norway,Europe,c,2007,F,1,1,12,16,12,0,40,16,12,16,16,60,100
3061,Oman,MENA,c,2007,NF,6,5,2,2,2,0,10,6,3,4,5,18,28
3062,Pakistan,Asia,c,2007,NF,6,5,2,6,3,0,11,8,6,4,6,24,35
3063,Pakistani Kashmir,Asia,t,2007,NF,7,5,2,3,2,2,5,6,4,4,6,20,25
3064,Palau,Asia,c,2007,F,1,1,12,15,10,0,37,16,11,15,13,55,92
3065,Palestinian Authority Administered Territories,MENA,t,2007,PF,4,6,6,9,3,0,18,5,5,1,5,16,34
3066,Panama,Americas,c,2007,F,1,2,12,15,9,0,36,15,11,9,12,47,83
3067,Papua New Guinea,Asia,c,2007,PF,3,3,9,11,6,0,26,12,9,7,8,36,62
3068,Paraguay,Americas,c,2007,PF,3,3,11,11,4,0,26,12,8,7,10,37,63
3069,Peru,Americas,c,2007,F,2,3,11,14,7,0,32,15,9,8,9,41,73
3070,Philippines,Asia,c,2007,PF,3,3,7,13,8,0,28,14,9,8,10,41,69
3071,Poland,Europe,c,2007,F,1,1,12,16,10,0,38,15,11,13,14,53,91
3072,Portugal,Europe,c,2007,F,1,1,12,16,12,0,40,16,12,15,14,57,97
3073,Puerto Rico,Americas,t,2007,F,1,1,12,15,10,0,37,16,11,14,14,55,92
3074,Qatar,MENA,c,2007,NF,6,5,2,1,3,0,9,8,2,4,4,18,27
3075,Romania,Europe,c,2007,F,2,2,11,14,7,0,32,14,11,12,12,49,81
3076,Russia,Eurasia,c,2007,NF,6,5,3,5,3,0,11,8,4,4,7,23,34
3077,Rwanda,SSA,c,2007,NF,6,5,3,3,4,0,10,7,3,6,7,23,33
3078,Samoa,Asia,c,2007,F,2,2,9,13,10,0,32,14,10,13,12,49,81
3079,San Marino,Europe,c,2007,F,1,1,12,16,12,0,40,16,12,16,16,60,100
3080,Sao Tome and Principe,SSA,c,2007,F,2,2,11,14,8,0,33,15,10,12,10,47,80
3081,Saudi Arabia,MENA,c,2007,NF,7,6,0,0,1,0,4,4,0,3,2,9,13
3082,Senegal,SSA,c,2007,F,2,3,11,13,9,0,33,15,10,9,9,43,76
3083,Serbia,Europe,c,2007,F,3,2,9,13,7,0,29,14,11,9,13,47,76
3084,Seychelles,SSA,c,2007,PF,3,3,8,10,7,0,25,10,9,11,11,41,66
3085,Sierra Leone,SSA,c,2007,PF,4,3,9,10,4,0,23,12,8,8,9,37,60
3086,Singapore,Asia,c,2007,PF,5,4,4,6,7,0,17,9,3,8,12,32,49
3087,Slovakia,Europe,c,2007,F,1,1,12,15,10,0,37,16,12,12,14,54,91
3088,Slovenia,Europe,c,2007,F,1,1,12,15,11,0,38,15,12,14,12,53,91
3089,Solomon Islands,Asia,c,2007,PF,4,3,6,10,7,0,23,13,9,8,12,42,65
3090,Somalia,SSA,c,2007,NF,7,7,0,0,1,0,1,3,0,0,0,3,4
3091,South Africa,SSA,c,2007,F,2,2,12,14,9,0,35,15,12,12,12,51,86
3092,South Korea,Asia,c,2007,F,1,2,11,15,10,0,36,14,12,13,12,51,87
3093,Spain,Europe,c,2007,F,1,1,12,15,12,0,39,16,12,14,15,57,96
3094,Sri Lanka,Asia,c,2007,PF,4,4,8,8,7,0,23,8,9,6,10,33,56
3095,St. Kitts and Nevis,Americas,c,2007,F,1,1,12,16,10,0,38,15,12,12,14,53,91
3096,St. Lucia,Americas,c,2007,F,1,1,12,16,10,0,38,15,12,12,14,53,91
3097,St. Vincent and the Grenadines,Americas,c,2007,F,2,1,11,15,8,0,34,15,11,13,14,53,87
3098,Sudan,SSA,c,2007,NF,7,7,0,4,3,4,3,4,3,0,0,7,10
3099,Suriname,Americas,c,2007,F,2,2,12,13,7,0,32,15,11,9,10,45,77
3100,Swaziland,SSA,c,2007,NF,7,5,0,1,1,0,3,8,3,4,5,20,23
3101,Sweden,Europe,c,2007,F,1,1,12,16,12,0,40,16,12,16,16,60,100
3102,Switzerland,Europe,c,2007,F,1,1,12,16,12,0,40,16,12,15,16,59,99
3103,Syria,MENA,c,2007,NF,7,6,0,0,1,0,1,2,0,1,5,8,9
3104,Taiwan,Asia,c,2007,F,2,1,10,15,9,0,34,16,11,15,13,55,89
3105,Tajikistan,Eurasia,c,2007,NF,6,5,2,4,3,1,8,6,4,4,6,20,28
3106,Tanzania,SSA,c,2007,PF,4,3,6,10,6,0,22,11,7,10,8,36,58
3107,Thailand,Asia,c,2007,NF,7,4,0,1,3,0,4,10,5,6,11,32,36
3108,The Gambia,SSA,c,2007,PF,5,4,6,7,4,0,17,10,6,7,8,31,48
3109,Tibet,Asia,t,2007,NF,7,7,0,0,1,3,-2,0,0,0,5,5,3
3110,Timor-Leste,Asia,c,2007,PF,3,4,11,10,5,0,26,11,7,6,9,33,59
3111,Togo,SSA,c,2007,NF,6,5,2,4,2,0,8,7,5,3,6,21,29
3112,Tonga,Asia,c,2007,PF,5,3,3,9,3,0,15,12,5,11,12,40,55
3113,Transnistria,Eurasia,t,2007,NF,6,6,2,4,1,0,7,6,2,2,5,15,22
3114,Trinidad and Tobago,Americas,c,2007,F,2,2,9,13,9,0,31,15,11,10,13,49,80
3115,Tunisia,MENA,c,2007,NF,6,5,1,3,2,0,6,4,2,4,8,18,24
3116,Turkey,Europe,c,2007,PF,3,3,9,12,7,0,28,12,7,8,10,37,65
3117,Turkmenistan,Eurasia,c,2007,NF,7,7,0,0,0,0,0,1,0,0,0,1,1
3118,Tuvalu,Asia,c,2007,F,1,1,12,15,10,0,37,16,12,15,14,57,94
3119,Uganda,SSA,c,2007,PF,5,4,4,7,4,0,15,11,6,7,7,31,46
3120,Ukraine,Eurasia,c,2007,F,3,2,9,13,6,0,28,13,10,11,11,45,73
3121,United Arab Emirates,MENA,c,2007,NF,6,5,1,1,2,0,8,6,3,4,4,17,25
3122,United Kingdom,Europe,c,2007,F,1,1,12,16,12,0,40,16,12,15,15,58,98
3123,United States,Americas,c,2007,F,1,1,11,16,11,0,38,16,10,14,15,55,93
3124,Uruguay,Americas,c,2007,F,1,1,12,16,11,0,39,16,12,15,15,58,97
3125,Uzbekistan,Eurasia,c,2007,NF,7,7,0,0,0,0,0,1,0,0,2,3,3
3126,Vanuatu,Asia,c,2007,F,2,2,9,15,8,0,32,16,11,10,11,48,80
3127,Venezuela,Americas,c,2007,PF,4,4,8,8,4,0,20,11,7,5,8,31,51
3128,Vietnam,Asia,c,2007,NF,7,5,0,1,1,0,2,5,2,4,8,19,21
3129,Western Sahara,MENA,t,2007,NF,7,6,0,0,0,2,-2,3,2,0,5,10,8
3130,Yemen,MENA,c,2007,PF,5,5,4,7,3,0,14,7,3,4,5,19,33
3131,Zambia,SSA,c,2007,PF,3,4,8,11,6,0,25,11,8,8,7,34,59
3132,Zimbabwe,SSA,c,2007,NF,7,6,1,3,0,0,4,5,2,1,1,9,13
3133,Abkhazia,Eurasia,t,2006,PF,5,5,5,5,3,0,13,8,4,4,5,21,34
3134,Afghanistan,Asia,c,2006,PF,5,5,6,7,3,0,16,5,5,4,5,19,35
3135,Albania,Europe,c,2006,PF,3,3,8,11,6,0,25,11,8,10,9,38,63
3136,Algeria,MENA,c,2006,NF,6,5,5,3,3,0,11,8,6,4,7,25,36
3137,Andorra,Europe,c,2006,F,1,1,12,15,12,0,39,16,11,15,15,57,96
3138,Angola,SSA,c,2006,NF,6,5,2,5,1,0,8,8,6,4,3,21,29
3139,Antigua and Barbuda,Americas,c,2006,F,2,2,11,12,7,0,30,13,9,12,13,47,77
3140,Argentina,Americas,c,2006,F,2,2,11,15,8,0,34,15,11,11,13,50,84
3141,Armenia,Eurasia,c,2006,PF,5,4,4,5,4,0,13,8,5,6,9,28,41
3142,Australia,Asia,c,2006,F,1,1,12,15,12,0,39,16,12,14,15,57,96
3143,Austria,Europe,c,2006,F,1,1,12,16,12,0,40,16,12,15,15,58,98
3144,Azerbaijan,Eurasia,c,2006,NF,6,5,3,4,3,0,10,7,3,5,8,23,33
3145,Bahamas,Americas,c,2006,F,1,1,12,16,10,0,38,16,12,15,15,58,96
3146,Bahrain,MENA,c,2006,PF,5,5,3,6,5,0,14,8,5,4,5,22,36
3147,Bangladesh,Asia,c,2006,PF,4,4,8,10,4,0,22,8,8,6,9,31,53
3148,Barbados,Americas,c,2006,F,1,1,12,16,12,0,40,16,12,16,15,59,99
3149,Belarus,Eurasia,c,2006,NF,7,6,1,3,1,0,5,3,0,2,5,10,15
3150,Belgium,Europe,c,2006,F,1,1,12,15,12,0,39,16,12,15,15,58,97
3151,Belize,Americas,c,2006,F,1,2,12,14,10,0,36,15,11,13,13,52,88
3152,Benin,SSA,c,2006,F,2,2,8,14,8,0,30,15,11,12,10,48,78
3153,Bhutan,Asia,c,2006,NF,6,5,2,1,5,1,9,6,2,4,8,20,29
3154,Bolivia,Americas,c,2006,PF,3,3,10,13,5,0,28,15,11,8,9,43,71
3155,Bosnia and Herzegovina,Europe,c,2006,PF,4,3,7,11,5,0,23,11,8,10,10,39,62
3156,Botswana,SSA,c,2006,F,2,2,11,11,9,0,31,14,10,13,10,47,78
3157,Brazil,Americas,c,2006,F,2,2,11,14,7,0,32,15,10,8,12,45,77
3158,Brunei,Asia,c,2006,NF,6,5,0,3,2,0,6,6,3,6,8,23,29
3159,Bulgaria,Europe,c,2006,F,1,2,12,15,9,0,36,14,11,13,13,51,87
3160,Burkina Faso,SSA,c,2006,PF,5,3,5,8,4,0,17,13,9,6,8,36,53
3161,Burundi,SSA,c,2006,PF,3,5,9,11,5,0,25,9,5,4,6,24,49
3162,Cambodia,Asia,c,2006,NF,6,5,3,5,3,0,11,9,6,2,7,24,35
3163,Cameroon,SSA,c,2006,NF,6,6,3,5,3,0,11,7,3,2,4,16,27
3164,Canada,Americas,c,2006,F,1,1,12,16,11,0,39,16,12,15,16,59,98
3165,Cape Verde,SSA,c,2006,F,1,1,12,15,10,0,37,15,11,14,13,53,90
3166,Central African Republic,SSA,c,2006,PF,5,4,7,7,3,0,17,10,9,3,5,27,44
3167,Chad,SSA,c,2006,NF,6,5,3,2,3,0,8,7,6,2,3,18,26
3168,Chechnya,Eurasia,t,2006,NF,7,7,0,0,0,0,0,4,0,0,1,5,5
3169,Chile,Americas,c,2006,F,1,1,12,15,12,0,39,16,12,15,14,57,96
3170,China,Asia,c,2006,NF,7,6,0,1,1,0,2,4,2,2,7,15,17
3171,Colombia,Americas,c,2006,PF,3,3,9,8,7,0,24,12,7,7,10,36,60
3172,Comoros,SSA,c,2006,PF,4,4,7,8,3,0,18,10,6,8,6,30,48
3173,Congo (Brazzaville),SSA,c,2006,PF,5,5,3,5,4,0,12,9,8,2,6,25,37
3174,Congo (Kinshasa),SSA,c,2006,NF,6,6,1,5,2,0,8,6,5,0,1,12,20
3175,Costa Rica,Americas,c,2006,F,1,1,12,15,11,0,38,16,11,14,13,54,92
3176,Cote d'Ivoire,SSA,c,2006,NF,6,6,2,2,2,0,6,5,3,3,4,15,21
3177,Croatia,Europe,c,2006,F,2,2,12,14,9,0,35,14,12,10,13,49,84
3178,Cuba,Americas,c,2006,NF,7,7,0,0,1,0,1,2,2,1,2,7,8
3179,Cyprus,Europe,c,2006,F,1,1,11,16,11,0,38,15,12,15,15,57,95
3180,Czech Republic,Europe,c,2006,F,1,1,12,15,10,0,37,16,12,13,14,55,92
3181,Denmark,Europe,c,2006,F,1,1,12,16,12,0,40,16,12,15,15,58,98
3182,Djibouti,SSA,c,2006,PF,5,5,4,5,3,0,12,7,5,5,6,23,35
3183,Dominica,Americas,c,2006,F,1,1,12,16,10,0,38,16,12,13,13,54,92
3184,Dominican Republic,Americas,c,2006,F,2,2,11,13,8,0,32,15,11,9,11,46,78
3185,Ecuador,Americas,c,2006,PF,3,3,8,15,4,0,27,15,11,5,10,41,68
3186,Egypt,MENA,c,2006,NF,6,5,2,4,2,0,8,7,3,5,7,22,30
3187,El Salvador,Americas,c,2006,F,2,3,12,13,7,0,32,15,10,8,10,43,75
3188,Equatorial Guinea,SSA,c,2006,NF,7,6,0,1,0,0,1,5,0,1,3,9,10
3189,Eritrea,SSA,c,2006,NF,7,6,0,1,2,0,3,2,0,3,6,11,14
3190,Estonia,Europe,c,2006,F,1,1,12,15,12,0,39,16,12,14,14,56,95
3191,Ethiopia,SSA,c,2006,PF,5,5,5,6,4,0,15,7,3,5,6,21,36
3192,Fiji,Asia,c,2006,PF,4,3,6,8,6,0,20,12,9,11,10,42,62
3193,Finland,Europe,c,2006,F,1,1,12,16,12,0,40,16,12,16,16,60,100
3194,France,Europe,c,2006,F,1,1,12,15,11,0,38,15,12,13,15,55,93
3195,Gabon,SSA,c,2006,PF,6,4,2,5,3,0,10,11,6,7,6,30,40
3196,Georgia,Eurasia,c,2006,PF,3,3,9,9,6,0,24,11,8,8,10,37,61
3197,Germany,Europe,c,2006,F,1,1,12,15,12,0,39,16,12,15,15,58,97
3198,Ghana,SSA,c,2006,F,1,2,12,15,10,0,37,14,11,12,10,47,84
3199,Greece,Europe,c,2006,F,1,2,12,15,10,0,37,15,10,13,13,51,88
3200,Grenada,Americas,c,2006,F,1,2,12,16,9,0,37,15,9,12,14,50,87
3201,Guatemala,Americas,c,2006,PF,4,4,9,8,5,0,22,12,8,5,8,33,55
3202,Guinea,SSA,c,2006,NF,6,5,2,5,2,0,9,8,5,4,6,23,32
3203,Guinea-Bissau,SSA,c,2006,PF,3,4,9,10,6,0,25,12,8,8,6,34,59
3204,Guyana,Americas,c,2006,PF,3,3,10,12,7,0,29,15,10,7,9,41,70
3205,Haiti,Americas,c,2006,NF,7,6,0,5,0,0,5,8,3,0,5,16,21
3206,Honduras,Americas,c,2006,PF,3,3,9,11,6,0,26,14,9,8,9,40,66
3207,Hong Kong,Asia,t,2006,PF,5,2,3,7,6,0,16,14,10,14,13,51,67
3208,Hungary,Europe,c,2006,F,1,1,12,15,10,0,37,16,12,14,14,56,93
3209,Iceland,Europe,c,2006,F,1,1,12,16,12,0,40,16,12,16,16,60,100
3210,India,Asia,c,2006,F,2,3,11,14,9,0,34,13,10,9,10,42,76
3211,Indian Kashmir,Asia,t,2006,PF,5,5,6,6,3,0,15,8,6,3,8,25,40
3212,Indonesia,Asia,c,2006,F,2,3,11,13,6,0,30,11,9,7,8,35,65
3213,Iran,MENA,c,2006,NF,6,6,3,3,3,0,9,5,3,3,4,15,24
3214,Iraq,MENA,c,2006,NF,6,5,3,4,2,0,9,6,5,2,6,19,28
3215,Ireland,Europe,c,2006,F,1,1,12,16,12,0,40,16,12,15,15,58,98
3216,Israel,MENA,c,2006,F,1,2,12,15,10,0,37,14,11,10,11,46,83
3217,Israeli Occupied Territories,MENA,t,2006,NF,6,5,2,2,3,1,6,6,5,2,5,18,24
3218,Italy,Europe,c,2006,F,1,1,12,16,11,0,39,14,12,12,15,53,92
3219,Jamaica,Americas,c,2006,F,2,3,10,13,8,0,31,15,9,8,11,43,74
3220,Japan,Asia,c,2006,F,1,2,12,15,10,0,37,13,10,15,13,51,88
3221,Jordan,MENA,c,2006,PF,5,4,4,7,4,0,15,8,5,7,7,27,42
3222,Kazakhstan,Eurasia,c,2006,NF,6,5,3,4,3,0,10,7,4,4,7,22,32
3223,Kenya,SSA,c,2006,PF,3,3,9,11,6,0,26,14,9,8,9,40,66
3224,Kiribati,Asia,c,2006,F,1,1,12,16,10,0,38,15,12,15,13,55,93
3225,Kosovo,Eurasia,t,2006,PF,6,5,5,5,3,0,10,6,6,2,5,19,29
3226,Kuwait,MENA,c,2006,PF,4,5,4,8,6,0,18,9,5,7,4,25,43
3227,Kyrgyzstan,Eurasia,c,2006,PF,5,4,5,7,4,0,16,11,8,5,7,31,47
3228,Laos,Asia,c,2006,NF,7,6,0,1,0,0,1,4,1,2,5,12,13
3229,Latvia,Europe,c,2006,F,1,1,12,15,9,0,36,16,12,12,13,53,89
3230,Lebanon,MENA,c,2006,PF,5,4,4,8,4,0,16,11,7,5,7,30,46
3231,Lesotho,SSA,c,2006,F,2,3,10,12,9,0,31,15,8,11,9,43,74
3232,Liberia,SSA,c,2006,PF,4,4,9,10,4,0,23,11,7,7,8,33,56
3233,Libya,MENA,c,2006,NF,7,7,0,1,0,0,1,1,0,0,5,6,7
3234,Liechtenstein,Europe,c,2006,F,1,1,12,16,12,0,40,16,12,16,15,59,99
3235,Lithuania,Europe,c,2006,F,1,1,12,15,9,0,36,16,11,14,13,54,90
3236,Luxembourg,Europe,c,2006,F,1,1,12,16,12,0,40,16,12,16,16,60,100
3237,Macedonia,Europe,c,2006,PF,3,3,8,10,7,0,25,11,7,8,10,36,61
3238,Madagascar,SSA,c,2006,PF,3,3,8,9,7,0,24,10,8,9,9,36,60
3239,Malawi,SSA,c,2006,PF,4,4,7,10,6,0,23,11,8,8,7,34,57
3240,Malaysia,Asia,c,2006,PF,4,4,6,7,6,0,19,10,6,6,9,31,50
3241,Maldives,Asia,c,2006,NF,6,5,3,2,4,0,9,6,3,6,7,22,31
3242,Mali,SSA,c,2006,F,2,2,9,12,9,0,30,15,9,11,9,44,74
3243,Malta,Europe,c,2006,F,1,1,12,16,11,0,39,16,12,16,15,59,98
3244,Marshall Islands,Asia,c,2006,F,1,1,12,15,10,0,37,16,11,15,13,55,92
3245,Mauritania,SSA,c,2006,PF,6,4,2,6,3,0,11,10,6,6,5,27,38
3246,Mauritius,SSA,c,2006,F,1,1,12,15,11,0,38,15,12,14,12,53,91
3247,Mexico,Americas,c,2006,F,2,2,12,14,9,0,35,15,10,8,12,45,80
3248,Micronesia,Asia,c,2006,F,1,1,12,15,10,0,37,16,11,15,14,56,93
3249,Moldova,Eurasia,c,2006,PF,3,4,9,8,7,0,24,10,6,8,9,33,57
3250,Monaco,Europe,c,2006,F,2,1,10,11,10,0,31,15,12,15,14,56,87
3251,Mongolia,Asia,c,2006,F,2,2,9,15,10,0,34,15,10,12,12,49,83
3252,Morocco,MENA,c,2006,PF,5,4,4,7,6,0,17,8,6,4,8,26,43
3253,Mozambique,SSA,c,2006,PF,3,4,7,11,7,0,25,10,7,6,8,31,56
3254,Myanmar,Asia,c,2006,NF,7,7,0,1,0,2,-1,2,0,0,4,6,5
3255,Nagorno-Karabakh,Eurasia,t,2006,PF,5,5,6,5,3,0,14,8,4,4,5,21,35
3256,Namibia,SSA,c,2006,F,2,2,10,12,9,0,31,15,12,10,9,46,77
3257,Nauru,Asia,c,2006,F,1,1,12,16,10,0,38,15,11,15,14,55,93
3258,Nepal,Asia,c,2006,NF,6,5,1,6,2,0,9,6,3,4,6,19,28
3259,Netherlands,Europe,c,2006,F,1,1,12,16,12,0,40,16,12,15,16,59,99
3260,New Zealand,Asia,c,2006,F,1,1,12,15,12,0,39,16,11,15,15,57,96
3261,Nicaragua,Americas,c,2006,PF,3,3,9,11,5,0,25,13,8,7,10,38,63
3262,Niger,SSA,c,2006,PF,3,3,10,10,7,0,27,11,7,10,7,35,62
3263,Nigeria,SSA,c,2006,PF,4,4,6,8,6,0,20,11,7,4,6,28,48
3264,North Korea,Asia,c,2006,NF,7,7,0,0,0,0,0,0,0,0,0,0,0
3265,Northern Cyprus,Europe,t,2006,F,2,2,11,14,9,0,34,13,9,12,12,46,80
3266,Norway,Europe,c,2006,F,1,1,12,16,12,0,40,16,12,16,16,60,100
3267,Oman,MENA,c,2006,NF,6,5,2,2,2,0,10,6,4,3,5,18,28
3268,Pakistan,Asia,c,2006,NF,6,5,2,6,3,0,11,8,6,4,6,24,35
3269,Pakistani Kashmir,Asia,t,2006,NF,7,5,2,3,2,2,5,6,4,4,6,20,25
3270,Palau,Asia,c,2006,F,1,1,12,15,10,0,37,16,11,15,13,55,92
3271,Palestinian Authority Administered Territories,MENA,t,2006,PF,5,5,5,7,4,0,16,5,5,2,5,17,33
3272,Panama,Americas,c,2006,F,1,2,12,15,9,0,36,15,11,9,12,47,83
3273,Papua New Guinea,Asia,c,2006,PF,3,3,9,11,6,0,26,12,9,9,8,38,64
3274,Paraguay,Americas,c,2006,PF,3,3,11,11,3,0,25,13,8,7,10,38,63
3275,Peru,Americas,c,2006,F,2,3,11,14,7,0,32,15,10,8,9,42,74
3276,Philippines,Asia,c,2006,PF,3,3,7,14,8,0,29,15,9,9,10,43,72
3277,Poland,Europe,c,2006,F,1,1,12,16,10,0,38,16,12,13,13,54,92
3278,Portugal,Europe,c,2006,F,1,1,12,16,12,0,40,16,12,15,14,57,97
3279,Puerto Rico,Americas,t,2006,F,1,1,12,15,10,0,37,16,11,14,14,55,92
3280,Qatar,MENA,c,2006,NF,6,5,2,1,3,0,9,8,2,4,4,18,27
3281,Romania,Europe,c,2006,F,2,2,10,13,7,0,30,13,10,11,11,45,75
3282,Russia,Eurasia,c,2006,NF,6,5,3,5,3,0,11,8,6,4,6,24,35
3283,Rwanda,SSA,c,2006,NF,6,5,3,3,5,0,11,7,3,6,5,21,32
3284,Samoa,Asia,c,2006,F,2,2,9,13,10,0,32,14,10,13,12,49,81
3285,San Marino,Europe,c,2006,F,1,1,12,16,12,0,40,16,12,16,16,60,100
3286,Sao Tome and Principe,SSA,c,2006,F,2,2,11,14,8,0,33,15,10,12,10,47,80
3287,Saudi Arabia,MENA,c,2006,NF,7,6,0,0,1,0,4,4,0,2,2,8,12
3288,Senegal,SSA,c,2006,F,2,3,12,12,9,0,33,15,9,10,9,43,76
3289,Serbia and Montenegro,Europe,c,2006,F,3,2,9,13,7,0,29,14,11,9,13,47,76
3290,Seychelles,SSA,c,2006,PF,3,3,8,11,7,0,26,11,9,11,11,42,68
3291,Sierra Leone,SSA,c,2006,PF,4,3,9,10,4,0,23,12,8,8,9,37,60
3292,Singapore,Asia,c,2006,PF,5,4,4,6,7,0,17,9,4,8,12,33,50
3293,Slovakia,Europe,c,2006,F,1,1,12,15,10,0,37,16,12,12,14,54,91
3294,Slovenia,Europe,c,2006,F,1,1,12,15,11,0,38,16,12,14,12,54,92
3295,Solomon Islands,Asia,c,2006,PF,3,3,7,10,7,0,24,13,9,8,12,42,66
3296,Somalia,SSA,c,2006,NF,6,7,0,4,4,0,8,3,1,3,0,7,15
3297,South Africa,SSA,c,2006,F,1,2,12,14,10,0,36,15,12,13,12,52,88
3298,South Korea,Asia,c,2006,F,1,2,11,15,10,0,36,14,12,12,11,49,85
3299,Spain,Europe,c,2006,F,1,1,12,14,12,0,38,16,12,14,15,57,95
3300,Sri Lanka,Asia,c,2006,PF,3,3,8,9,7,0,24,9,9,7,10,35,59
3301,St. Kitts and Nevis,Americas,c,2006,F,1,1,12,16,10,0,38,15,12,12,14,53,91
3302,St. Lucia,Americas,c,2006,F,1,1,12,16,10,0,38,15,12,12,14,53,91
3303,St. Vincent and the Grenadines,Americas,c,2006,F,2,1,9,15,8,0,32,15,11,13,14,53,85
3304,Sudan,SSA,c,2006,NF,7,7,0,4,1,4,1,4,1,0,1,6,7
3305,Suriname,Americas,c,2006,F,2,2,12,13,8,0,33,15,11,9,10,45,78
3306,Swaziland,SSA,c,2006,NF,7,5,0,1,0,0,1,8,3,4,5,20,21
3307,Sweden,Europe,c,2006,F,1,1,12,16,12,0,40,16,12,16,16,60,100
3308,Switzerland,Europe,c,2006,F,1,1,12,16,12,0,40,16,12,15,16,59,99
3309,Syria,MENA,c,2006,NF,7,7,0,0,1,0,1,2,0,1,4,7,8
3310,Taiwan,Asia,c,2006,F,1,1,11,15,10,0,36,16,11,15,13,55,91
3311,Tajikistan,Eurasia,c,2006,NF,6,5,2,4,3,0,9,7,4,4,6,21,30
3312,Tanzania,SSA,c,2006,PF,4,3,6,10,6,0,22,11,7,10,8,36,58
3313,Thailand,Asia,c,2006,PF,3,3,9,12,8,0,29,11,8,8,11,38,67
3314,The Gambia,SSA,c,2006,PF,5,4,6,7,4,0,17,10,6,8,8,32,49
3315,Tibet,Asia,t,2006,NF,7,7,0,0,1,3,-2,0,0,0,5,5,3
3316,Timor-Leste,Asia,c,2006,PF,3,3,11,10,8,0,29,13,8,8,9,38,67
3317,Togo,SSA,c,2006,NF,6,5,2,3,2,0,7,7,3,1,7,18,25
3318,Tonga,Asia,c,2006,PF,5,3,3,9,3,0,15,12,7,12,11,42,57
3319,Transnistria,Eurasia,t,2006,NF,6,6,2,3,1,0,6,6,2,2,5,15,21
3320,Trinidad and Tobago,Americas,c,2006,F,3,2,9,11,8,0,28,14,11,10,11,46,74
3321,Tunisia,MENA,c,2006,NF,6,5,1,3,2,0,6,4,2,4,8,18,24
3322,Turkey,Europe,c,2006,PF,3,3,9,12,7,0,28,12,7,8,10,37,65
3323,Turkmenistan,Eurasia,c,2006,NF,7,7,0,0,0,0,0,1,0,0,0,1,1
3324,Tuvalu,Asia,c,2006,F,1,1,12,15,10,0,37,16,12,15,14,57,94
3325,Uganda,SSA,c,2006,PF,5,4,3,6,5,0,14,11,6,7,7,31,45
3326,Ukraine,Eurasia,c,2006,F,3,2,8,12,7,0,27,13,10,11,11,45,72
3327,United Arab Emirates,MENA,c,2006,NF,6,6,0,1,2,0,7,6,1,4,4,15,22
3328,United Kingdom,Europe,c,2006,F,1,1,12,15,12,0,39,16,12,14,15,57,96
3329,United States,Americas,c,2006,F,1,1,10,16,11,0,37,16,11,14,15,56,93
3330,Uruguay,Americas,c,2006,F,1,1,12,16,11,0,39,16,12,15,15,58,97
3331,Uzbekistan,Eurasia,c,2006,NF,7,7,0,0,0,0,0,1,0,0,2,3,3
3332,Vanuatu,Asia,c,2006,F,2,2,9,15,8,0,32,16,11,10,11,48,80
3333,Venezuela,Americas,c,2006,PF,4,4,10,8,5,0,23,11,7,5,8,31,54
3334,Vietnam,Asia,c,2006,NF,7,5,0,1,1,0,2,3,2,4,8,17,19
3335,Western Sahara,MENA,t,2006,NF,7,6,0,0,0,2,-2,3,2,0,5,10,8
3336,Yemen,MENA,c,2006,PF,5,5,4,6,3,0,13,7,3,3,5,18,31
3337,Zambia,SSA,c,2006,PF,4,4,5,11,6,0,22,11,8,8,7,34,56
3338,Zimbabwe,SSA,c,2006,NF,7,6,1,4,0,0,5,5,3,1,1,10,15
